STRAIN	TOTAL	CORE	ACCESSORY	SINGLETON	CHROM	START	END
Aspergillus_fumigatus_IFM_59355-2	33	33	0	0	scaffold_2	670475	770475
Aspergillus_fumigatus_IFM_59355-2	42	40	2	0	scaffold_4	152226	252226
Aspergillus_fumigatus_IFM_59355-2	28	25	3	0	scaffold_1	1429074	1529074
Aspergillus_fumigatus_IFM_59355-2	31	28	3	0	scaffold_1	965662	1065662
Aspergillus_fumigatus_IFM_59355-2	17	16	1	0	scaffold_1	1833332	1933332
Aspergillus_fumigatus_IFM_59355-2	35	34	1	0	scaffold_1	2511905	2611905
Aspergillus_fumigatus_IFM_59355-2	27	3	24	0	scaffold_3	649160	749160
Aspergillus_fumigatus_IFM_59355-2	32	31	1	0	scaffold_2	3667691	3767691
Aspergillus_fumigatus_IFM_59355-2	44	42	2	0	scaffold_5	1060537	1160537
Aspergillus_fumigatus_IFM_59355-2	39	39	0	0	scaffold_2	1437162	1537162
Aspergillus_fumigatus_IFM_59355-2	37	37	0	0	scaffold_4	2988014	3088014
Aspergillus_fumigatus_IFM_59355-2	38	36	2	0	scaffold_2	144150	244150
Aspergillus_fumigatus_IFM_59355-2	41	40	1	0	scaffold_6	2021559	2121559
Aspergillus_fumigatus_IFM_59355-2	35	16	19	0	scaffold_3	750485	850485
Aspergillus_fumigatus_IFM_59355-2	40	36	4	0	scaffold_1	3225973	3325973
Aspergillus_fumigatus_IFM_59355-2	40	35	5	0	scaffold_1	3273790	3373790
Aspergillus_fumigatus_IFM_59355-2	36	29	7	0	scaffold_5	674712	774712
Aspergillus_fumigatus_IFM_59355-2	34	30	4	0	scaffold_6	1288122	1388122
Aspergillus_fumigatus_IFM_59355-2	34	31	3	0	scaffold_4	2796250	2896250
Aspergillus_fumigatus_IFM_59355-2	50	42	8	0	scaffold_4	3638541	3738541
Aspergillus_fumigatus_IFM_59355-2	36	32	4	0	scaffold_2	1215899	1315899
Aspergillus_fumigatus_IFM_59355-2	46	39	7	0	scaffold_4	2365377	2465377
Aspergillus_fumigatus_IFM_59355-2	38	35	3	0	scaffold_7	1384173	1484173
Aspergillus_fumigatus_IFM_59355-2	41	36	5	0	scaffold_2	4142975	4242975
Aspergillus_fumigatus_IFM_59355-2	42	38	4	0	scaffold_5	3434390	3534390
Aspergillus_fumigatus_IFM_59355-2	42	38	4	0	scaffold_3	3547549	3647549
Aspergillus_fumigatus_IFM_59355-2	43	40	3	0	scaffold_1	3778330	3878330
Aspergillus_fumigatus_IFM_59355-2	41	37	4	0	scaffold_1	4529661	4629661
Aspergillus_fumigatus_IFM_59355-2	40	36	4	0	scaffold_2	3373908	3473908
Aspergillus_fumigatus_IFM_59355-2	46	45	1	0	scaffold_5	1822242	1922242
Aspergillus_fumigatus_IFM_59355-2	39	37	2	0	scaffold_2	4201802	4301802
Aspergillus_fumigatus_IFM_59355-2	21	18	3	0	scaffold_6	159076	259076
Aspergillus_fumigatus_IFM_59355-2	15	7	8	0	scaffold_7	874024	974024
Aspergillus_fumigatus_IFM_59355-2	32	28	4	0	scaffold_2	1011786	1111786
Aspergillus_fumigatus_IFM_59355-2	35	34	1	0	scaffold_2	3020052	3120052
Aspergillus_fumigatus_IFM_59355-2	26	25	1	0	scaffold_4	1058151	1158151
Aspergillus_fumigatus_IFM_59355-2	47	42	5	0	scaffold_3	2488050	2588050
Aspergillus_fumigatus_IFM_59355-2	38	36	2	0	scaffold_5	1577378	1677378
Aspergillus_fumigatus_IFM_59355-2	24	22	2	0	scaffold_6	1257280	1357280
Aspergillus_fumigatus_IFM_59355-2	37	32	5	0	scaffold_8	1007754	1107754
Aspergillus_fumigatus_IFM_59355-2	41	39	2	0	scaffold_5	1043637	1143637
Aspergillus_fumigatus_IFM_59355-2	36	31	5	0	scaffold_8	67577	167577
Aspergillus_fumigatus_IFM_59355-2	29	27	2	0	scaffold_4	2007139	2107139
Aspergillus_fumigatus_IFM_59355-2	37	33	4	0	scaffold_6	1294376	1394376
Aspergillus_fumigatus_IFM_59355-2	35	32	3	0	scaffold_6	3408694	3508694
Aspergillus_fumigatus_IFM_59355-2	43	40	3	0	scaffold_1	3303677	3403677
Aspergillus_fumigatus_IFM_59355-2	33	17	16	0	scaffold_3	903533	1003533
Aspergillus_fumigatus_IFM_59355-2	42	39	3	0	scaffold_1	3297304	3397304
Aspergillus_fumigatus_IFM_59355-2	36	34	2	0	scaffold_4	2784042	2884042
Aspergillus_fumigatus_IFM_59355-2	33	31	2	0	scaffold_8	1339873	1439873
Aspergillus_fumigatus_IFM_59355-2	32	31	1	0	scaffold_5	1411687	1511687
Aspergillus_fumigatus_IFM_59355-2	42	37	5	0	scaffold_7	1950951	2050951
Aspergillus_fumigatus_IFM_59355-2	35	24	11	0	scaffold_1	4331003	4431003
Aspergillus_fumigatus_IFM_59355-2	33	11	22	0	scaffold_3	722591	822591
Aspergillus_fumigatus_IFM_59355-2	35	34	1	0	scaffold_2	3019965	3119965
Aspergillus_fumigatus_IFM_59355-2	38	37	1	0	scaffold_4	1910623	2010623
Aspergillus_fumigatus_IFM_59355-2	35	33	2	0	scaffold_5	982639	1082639
Aspergillus_fumigatus_IFM_59355-2	35	29	6	0	scaffold_7	1878966	1978966
Aspergillus_fumigatus_IFM_59355-2	44	39	5	0	scaffold_7	1967759	2067759
Aspergillus_fumigatus_IFM_59355-2	26	23	3	0	scaffold_7	941212	1041212
Aspergillus_fumigatus_IFM_59355-2	35	35	0	0	scaffold_4	2151087	2251087
Aspergillus_fumigatus_IFM_59355-2	35	34	1	0	scaffold_2	3017570	3117570
Aspergillus_fumigatus_IFM_59355-2	43	34	9	0	scaffold_1	159558	259558
Aspergillus_fumigatus_IFM_59355-2	39	39	0	0	scaffold_4	880957	980957
Aspergillus_fumigatus_IFM_59355-2	40	37	3	0	scaffold_7	98966	198966
Aspergillus_fumigatus_IFM_59355-2	33	32	1	0	scaffold_4	1813770	1913770
Aspergillus_fumigatus_IFM_59355-2	38	36	2	0	scaffold_6	660960	760960
Aspergillus_fumigatus_IFM_59355-2	32	29	3	0	scaffold_3	1909768	2009768
Aspergillus_fumigatus_IFM_59355-2	33	32	1	0	scaffold_7	1458693	1558693
Aspergillus_fumigatus_IFM_59355-2	41	36	5	0	scaffold_2	1681817	1781817
Aspergillus_fumigatus_IFM_59355-2	40	39	1	0	scaffold_7	1414295	1514295
Aspergillus_fumigatus_IFM_59355-2	32	12	20	0	scaffold_3	742009	842009
Aspergillus_fumigatus_IFM_59355-2	41	39	2	0	scaffold_2	1377681	1477681
Aspergillus_fumigatus_IFM_59355-2	31	27	4	0	scaffold_4	2056303	2156303
Aspergillus_fumigatus_IFM_59355-2	32	31	1	0	scaffold_4	1296326	1396326
Aspergillus_fumigatus_IFM_59355-2	29	27	2	0	scaffold_3	2947588	3047588
Aspergillus_fumigatus_IFM_59355-2	35	34	1	0	scaffold_1	2511795	2611795
Aspergillus_fumigatus_IFM_59355-2	32	28	4	0	scaffold_1	1402324	1502324
Aspergillus_fumigatus_IFM_59355-2	42	39	3	0	scaffold_3	2392845	2492845
Aspergillus_fumigatus_IFM_59355-2	21	19	2	0	scaffold_4	990532	1090532
Aspergillus_fumigatus_IFM_59355-2	25	22	3	0	scaffold_1	1686542	1786542
Aspergillus_fumigatus_IFM_59355-2	39	37	2	0	scaffold_1	2168133	2268133
Aspergillus_fumigatus_IFM_59355-2	40	38	2	0	scaffold_5	1041324	1141324
Aspergillus_fumigatus_IFM_59355-2	40	39	1	0	scaffold_5	1677369	1777369
Aspergillus_fumigatus_IFM_59355-2	36	33	3	0	scaffold_5	2570647	2670647
Aspergillus_fumigatus_IFM_59355-2	34	28	6	0	scaffold_5	3491294	3591294
Aspergillus_fumigatus_IFM_59355-2	48	44	4	0	scaffold_2	14107	114107
Aspergillus_fumigatus_IFM_59355-2	39	33	6	0	scaffold_1	3901837	4001837
Aspergillus_fumigatus_IFM_59355-2	46	36	10	0	scaffold_1	14669	114669
Aspergillus_fumigatus_IFM_59355-2	36	34	2	0	scaffold_2	446508	546508
Aspergillus_fumigatus_IFM_59355-2	42	37	5	0	scaffold_7	65919	165919
Aspergillus_fumigatus_IFM_59355-2	34	32	2	0	scaffold_3	2214632	2314632
Aspergillus_fumigatus_IFM_59355-2	43	40	3	0	scaffold_1	3767208	3867208
Aspergillus_fumigatus_IFM_59355-2	49	39	10	0	scaffold_6	22604	122604
Aspergillus_fumigatus_IFM_59355-2	38	36	2	0	scaffold_2	2396363	2496363
Aspergillus_fumigatus_IFM_59355-2	38	37	1	0	scaffold_7	1124152	1224152
Aspergillus_fumigatus_IFM_59355-2	29	27	2	0	scaffold_3	3395474	3495474
Aspergillus_fumigatus_IFM_59355-2	41	38	3	0	scaffold_2	2025741	2125741
Aspergillus_fumigatus_IFM_59355-2	42	41	1	0	scaffold_1	437301	537301
Aspergillus_fumigatus_IFM_59355-2	35	30	5	0	scaffold_6	1879549	1979549
Aspergillus_fumigatus_IFM_59355-2	41	35	6	0	scaffold_6	2428990	2528990
Aspergillus_fumigatus_IFM_59355-2	34	28	6	0	scaffold_2	3911891	4011891
Aspergillus_fumigatus_IFM_59355-2	39	37	2	0	scaffold_6	3306662	3406662
Aspergillus_fumigatus_IFM_59355-2	49	42	7	0	scaffold_5	3401207	3501207
Aspergillus_fumigatus_IFM_59355-2	45	39	6	0	scaffold_5	3346519	3446519
Aspergillus_fumigatus_IFM_59355-2	41	38	3	0	scaffold_2	2027364	2127364
Aspergillus_fumigatus_IFM_59355-2	40	38	2	0	scaffold_8	506251	606251
Aspergillus_fumigatus_IFM_59355-2	30	29	1	0	scaffold_4	1995171	2095171
Aspergillus_fumigatus_IFM_59355-2	37	31	6	0	scaffold_7	1868815	1968815
Aspergillus_fumigatus_IFM_59355-2	29	24	5	0	scaffold_1	1413116	1513116
Aspergillus_fumigatus_IFM_59355-2	41	39	2	0	scaffold_5	1036095	1136095
Aspergillus_fumigatus_IFM_59355-2	36	17	19	0	scaffold_3	786420	886420
Aspergillus_fumigatus_IFM_59355-2	33	31	2	0	scaffold_8	1339879	1439879
Aspergillus_fumigatus_IFM_59355-2	33	31	2	0	scaffold_1	1463430	1563430
Aspergillus_fumigatus_IFM_59355-2	44	39	5	0	scaffold_5	735858	835858
Aspergillus_fumigatus_IFM_59355-2	33	32	1	0	scaffold_1	2710232	2810232
Aspergillus_fumigatus_IFM_59355-2	31	30	1	0	scaffold_1	922942	1022942
Aspergillus_fumigatus_IFM_59355-2	30	27	3	0	scaffold_4	1769281	1869281
Aspergillus_fumigatus_IFM_59355-2	51	37	14	0	scaffold_1	31680	131680
Aspergillus_fumigatus_IFM_59355-2	41	40	1	0	scaffold_4	202533	302533
Aspergillus_fumigatus_IFM_59355-2	39	34	5	0	scaffold_5	555981	655981
Aspergillus_fumigatus_IFM_59355-2	45	40	5	0	scaffold_4	2385409	2485409
Aspergillus_fumigatus_IFM_59355-2	33	32	1	0	scaffold_2	3674142	3774142
Aspergillus_fumigatus_IFM_59355-2	47	43	4	0	scaffold_8	1557962	1657962
Aspergillus_fumigatus_IFM_59355-2	33	22	11	0	scaffold_3	884877	984877
Aspergillus_fumigatus_IFM_59355-2	32	26	6	0	scaffold_3	3770041	3870041
Aspergillus_fumigatus_IFM_59355-2	33	32	1	0	scaffold_2	4060472	4160472
Aspergillus_fumigatus_IFM_59355-2	32	28	4	0	scaffold_5	516659	616659
Aspergillus_fumigatus_IFM_59355-2	38	33	5	0	scaffold_5	3310029	3410029
Aspergillus_fumigatus_IFM_59355-2	34	33	1	0	scaffold_1	2703590	2803590
Aspergillus_fumigatus_IFM_59355-2	38	35	3	0	scaffold_5	1987025	2087025
Aspergillus_fumigatus_IFM_59355-2	41	35	6	0	scaffold_5	336558	436558
Aspergillus_fumigatus_IFM_59355-2	40	36	4	0	scaffold_1	3354001	3454001
Aspergillus_fumigatus_IFM_59355-2	42	41	1	0	scaffold_6	2034127	2134127
Aspergillus_fumigatus_IFM_59355-2	40	13	27	0	scaffold_1	4251385	4351385
Aspergillus_fumigatus_IFM_59355-2	36	33	3	0	scaffold_6	1072512	1172512
Aspergillus_fumigatus_IFM_59355-2	43	36	7	0	scaffold_4	275974	375974
Aspergillus_fumigatus_IFM_59355-2	40	38	2	0	scaffold_5	857844	957844
Aspergillus_fumigatus_IFM_59355-2	36	32	4	0	scaffold_6	446083	546083
Aspergillus_fumigatus_IFM_59355-2	35	31	4	0	scaffold_8	1604526	1704526
Aspergillus_fumigatus_IFM_59355-2	40	31	9	0	scaffold_5	2232845	2332845
Aspergillus_fumigatus_IFM_59355-2	42	39	3	0	scaffold_3	254936	354936
Aspergillus_fumigatus_IFM_59355-2	38	37	1	0	scaffold_4	1873457	1973457
Aspergillus_fumigatus_IFM_59355-2	31	26	5	0	scaffold_7	581345	681345
Aspergillus_fumigatus_IFM_59355-2	36	33	3	0	scaffold_6	473156	573156
Aspergillus_fumigatus_IFM_59355-2	40	37	3	0	scaffold_2	3448148	3548148
Aspergillus_fumigatus_IFM_59355-2	39	14	25	0	scaffold_1	4299969	4399969
Aspergillus_fumigatus_IFM_59355-2	29	27	2	0	scaffold_4	1368449	1468449
Aspergillus_fumigatus_IFM_59355-2	39	36	3	0	scaffold_3	3534500	3634500
Aspergillus_fumigatus_IFM_59355-2	34	31	3	0	scaffold_1	1548050	1648050
Aspergillus_fumigatus_IFM_59355-2	35	29	6	0	scaffold_7	610143	710143
Aspergillus_fumigatus_IFM_59355-2	36	31	5	0	scaffold_2	485083	585083
Aspergillus_fumigatus_IFM_59355-2	31	26	5	0	scaffold_7	584245	684245
Aspergillus_fumigatus_IFM_59355-2	35	31	4	0	scaffold_6	2644517	2744517
Aspergillus_fumigatus_IFM_59355-2	31	28	3	0	scaffold_1	1503026	1603026
Aspergillus_fumigatus_IFM_59355-2	32	31	1	0	scaffold_5	2612917	2712917
Aspergillus_fumigatus_IFM_59355-2	41	40	1	0	scaffold_3	1729699	1829699
Aspergillus_fumigatus_IFM_59355-2	34	31	3	0	scaffold_5	1256893	1356893
Aspergillus_fumigatus_IFM_59355-2	33	32	1	0	scaffold_1	2711151	2811151
Aspergillus_fumigatus_IFM_59355-2	39	34	5	0	scaffold_7	1688241	1788241
Aspergillus_fumigatus_IFM_59355-2	27	25	2	0	scaffold_4	1325069	1425069
Aspergillus_fumigatus_IFM_59355-2	38	33	5	0	scaffold_1	3144402	3244402
Aspergillus_fumigatus_IFM_59355-2	39	37	2	0	scaffold_1	2622253	2722253
Aspergillus_fumigatus_IFM_59355-2	40	36	4	0	scaffold_1	3339709	3439709
Aspergillus_fumigatus_IFM_59355-2	37	33	4	0	scaffold_2	2850330	2950330
Aspergillus_fumigatus_IFM_59355-2	34	32	2	0	scaffold_4	1268398	1368398
Aspergillus_fumigatus_IFM_59355-2	40	38	2	0	scaffold_1	2463030	2563030
Aspergillus_fumigatus_IFM_59355-2	4	3	1	0	scaffold_3	1387727	1487727
Aspergillus_fumigatus_IFM_59355-2	34	32	2	0	scaffold_5	972259	1072259
Aspergillus_fumigatus_IFM_59355-2	41	34	7	0	scaffold_7	463555	563555
Aspergillus_fumigatus_IFM_59355-2	38	34	4	0	scaffold_6	1503954	1603954
Aspergillus_fumigatus_IFM_59355-2	37	35	2	0	scaffold_2	2988438	3088438
Aspergillus_fumigatus_IFM_59355-2	34	29	5	0	scaffold_1	3993748	4093748
Aspergillus_fumigatus_IFM_59355-2	35	33	2	0	scaffold_7	739100	839100
Aspergillus_fumigatus_IFM_59355-2	39	28	11	0	scaffold_5	2198177	2298177
Aspergillus_fumigatus_IFM_59355-2	36	32	4	0	scaffold_2	3511361	3611361
Aspergillus_fumigatus_IFM_59355-2	38	37	1	0	scaffold_4	2467540	2567540
Aspergillus_fumigatus_IFM_59355-2	37	35	2	0	scaffold_4	1128720	1228720
Aspergillus_fumigatus_IFM_59355-2	40	24	16	0	scaffold_1	4202487	4302487
Aspergillus_fumigatus_IFM_59355-2	41	36	5	0	scaffold_4	2317720	2417720
Aspergillus_fumigatus_IFM_59355-2	30	27	3	0	scaffold_5	1248541	1348541
Aspergillus_fumigatus_IFM_59355-2	40	35	5	0	scaffold_8	1592484	1692484
Aspergillus_fumigatus_IFM_59355-2	45	42	3	0	scaffold_3	167205	267205
Aspergillus_fumigatus_IFM_59355-2	36	36	0	0	scaffold_3	1958062	2058062
Aspergillus_fumigatus_IFM_59355-2	34	34	0	0	scaffold_1	616615	716615
Aspergillus_fumigatus_IFM_59355-2	35	30	5	0	scaffold_1	2931716	3031716
Aspergillus_fumigatus_IFM_59355-2	26	23	3	0	scaffold_1	1984245	2084245
Aspergillus_fumigatus_IFM_59355-2	36	34	2	0	scaffold_3	1652317	1752317
Aspergillus_fumigatus_IFM_59355-2	42	39	3	0	scaffold_2	1363387	1463387
Aspergillus_fumigatus_IFM_59355-2	39	36	3	0	scaffold_6	680683	780683
Aspergillus_fumigatus_IFM_59355-2	36	32	4	0	scaffold_3	2679801	2779801
Aspergillus_fumigatus_IFM_59355-2	33	31	2	0	scaffold_6	1726745	1826745
Aspergillus_fumigatus_IFM_59355-2	38	31	7	0	scaffold_1	3525696	3625696
Aspergillus_fumigatus_IFM_59355-2	32	30	2	0	scaffold_4	1999498	2099498
Aspergillus_fumigatus_IFM_59355-2	43	41	2	0	scaffold_6	3456990	3556990
Aspergillus_fumigatus_IFM_59355-2	37	33	4	0	scaffold_2	1293308	1393308
Aspergillus_fumigatus_IFM_59355-2	34	29	5	0	scaffold_5	2150575	2250575
Aspergillus_fumigatus_IFM_59355-2	45	44	1	0	scaffold_3	1755408	1855408
Aspergillus_fumigatus_IFM_59355-2	41	35	6	0	scaffold_4	325098	425098
Aspergillus_fumigatus_IFM_59355-2	34	33	1	0	scaffold_3	3208369	3308369
Aspergillus_fumigatus_IFM_59355-2	33	32	1	0	scaffold_2	3674615	3774615
Aspergillus_fumigatus_IFM_59355-2	40	36	4	0	scaffold_6	1123797	1223797
Aspergillus_fumigatus_IFM_59355-2	43	39	4	0	scaffold_6	3440313	3540313
Aspergillus_fumigatus_IFM_59355-2	35	30	5	0	scaffold_2	3563476	3663476
Aspergillus_fumigatus_IFM_59355-2	47	44	3	0	scaffold_5	813290	913290
Aspergillus_fumigatus_IFM_59355-2	32	32	0	0	scaffold_2	177468	277468
Aspergillus_fumigatus_IFM_59355-2	45	42	3	0	scaffold_2	3997387	4097387
Aspergillus_fumigatus_IFM_59355-2	43	40	3	0	scaffold_2	2816403	2916403
Aspergillus_fumigatus_IFM_59355-2	42	37	5	0	scaffold_7	1948502	2048502
Aspergillus_fumigatus_IFM_59355-2	44	28	16	0	scaffold_4	3356752	3456752
Aspergillus_fumigatus_IFM_59355-2	45	43	2	0	scaffold_3	169978	269978
Aspergillus_fumigatus_IFM_59355-2	39	34	5	0	scaffold_2	1630681	1730681
Aspergillus_fumigatus_IFM_59355-2	40	34	6	0	scaffold_5	391050	491050
Aspergillus_fumigatus_IFM_59355-2	37	37	0	0	scaffold_6	3554285	3654285
Aspergillus_fumigatus_IFM_59355-2	40	39	1	0	scaffold_4	818028	918028
Aspergillus_fumigatus_IFM_59355-2	29	29	0	0	scaffold_2	941458	1041458
Aspergillus_fumigatus_IFM_59355-2	31	30	1	0	scaffold_3	2843187	2943187
Aspergillus_fumigatus_IFM_59355-2	41	35	6	0	scaffold_4	2339754	2439754
Aspergillus_fumigatus_IFM_59355-2	33	29	4	0	scaffold_1	1106174	1206174
Aspergillus_fumigatus_IFM_59355-2	46	41	5	0	scaffold_2	3961417	4061417
Aspergillus_fumigatus_IFM_59355-2	39	35	4	0	scaffold_2	367938	467938
Aspergillus_fumigatus_IFM_59355-2	33	32	1	0	scaffold_1	3100325	3200325
Aspergillus_fumigatus_IFM_59355-2	36	34	2	0	scaffold_3	1614757	1714757
Aspergillus_fumigatus_IFM_59355-2	32	30	2	0	scaffold_3	2849844	2949844
Aspergillus_fumigatus_IFM_59355-2	40	39	1	0	scaffold_3	1776895	1876895
Aspergillus_fumigatus_IFM_59355-2	34	26	8	0	scaffold_6	2887424	2987424
Aspergillus_fumigatus_IFM_59355-2	38	35	3	0	scaffold_1	364895	464895
Aspergillus_fumigatus_IFM_59355-2	36	35	1	0	scaffold_3	3071512	3171512
Aspergillus_fumigatus_IFM_59355-2	35	35	0	0	scaffold_1	632023	732023
Aspergillus_fumigatus_IFM_59355-2	32	30	2	0	scaffold_2	1275537	1375537
Aspergillus_fumigatus_IFM_59355-2	38	32	6	0	scaffold_6	83607	183607
Aspergillus_fumigatus_IFM_59355-2	37	33	4	0	scaffold_5	2466369	2566369
Aspergillus_fumigatus_IFM_59355-2	38	6	32	0	scaffold_3	1015124	1115124
Aspergillus_fumigatus_IFM_59355-2	33	29	4	0	scaffold_5	517992	617992
Aspergillus_fumigatus_IFM_59355-2	34	33	1	0	scaffold_2	286014	386014
Aspergillus_fumigatus_IFM_59355-2	23	20	3	0	scaffold_4	3108148	3208148
Aspergillus_fumigatus_IFM_59355-2	36	34	2	0	scaffold_1	792999	892999
Aspergillus_fumigatus_IFM_59355-2	30	27	3	0	scaffold_1	1562156	1662156
Aspergillus_fumigatus_IFM_59355-2	39	30	9	0	scaffold_3	17676	117676
Aspergillus_fumigatus_IFM_59355-2	37	34	3	0	scaffold_6	334156	434156
Aspergillus_fumigatus_IFM_59355-2	35	35	0	0	scaffold_1	2364119	2464119
Aspergillus_fumigatus_IFM_59355-2	37	35	2	0	scaffold_6	972149	1072149
Aspergillus_fumigatus_IFM_59355-2	44	35	9	0	scaffold_1	4083716	4183716
Aspergillus_fumigatus_IFM_59355-2	40	36	4	0	scaffold_8	451139	551139
Aspergillus_fumigatus_IFM_59355-2	50	44	6	0	scaffold_4	3663427	3763427
Aspergillus_fumigatus_IFM_59355-2	34	34	0	0	scaffold_4	2608294	2708294
Aspergillus_fumigatus_IFM_59355-2	35	32	3	0	scaffold_1	3671394	3771394
Aspergillus_fumigatus_IFM_59355-2	36	29	7	0	scaffold_4	1548273	1648273
Aspergillus_fumigatus_IFM_59355-2	34	31	3	0	scaffold_3	2672274	2772274
Aspergillus_fumigatus_IFM_59355-2	37	34	3	0	scaffold_2	4282076	4382076
Aspergillus_fumigatus_IFM_59355-2	34	25	9	0	scaffold_6	2867535	2967535
Aspergillus_fumigatus_IFM_59355-2	36	36	0	0	scaffold_4	708218	808218
Aspergillus_fumigatus_IFM_59355-2	49	37	12	0	scaffold_1	44576	144576
Aspergillus_fumigatus_IFM_59355-2	32	30	2	0	scaffold_2	3854212	3954212
Aspergillus_fumigatus_IFM_59355-2	36	35	1	0	scaffold_2	600643	700643
Aspergillus_fumigatus_IFM_59355-2	38	31	7	0	scaffold_6	2448412	2548412
Aspergillus_fumigatus_IFM_59355-2	43	40	3	0	scaffold_3	2365801	2465801
Aspergillus_fumigatus_IFM_59355-2	35	34	1	0	scaffold_5	1402887	1502887
Aspergillus_fumigatus_IFM_59355-2	28	1	27	0	scaffold_8	1843599	1943599
Aspergillus_fumigatus_IFM_59355-2	45	44	1	0	scaffold_3	1757662	1857662
Aspergillus_fumigatus_IFM_59355-2	35	33	2	0	scaffold_7	651024	751024
Aspergillus_fumigatus_IFM_59355-2	33	27	6	0	scaffold_7	614192	714192
Aspergillus_fumigatus_IFM_59355-2	37	5	32	0	scaffold_3	1012514	1112514
Aspergillus_fumigatus_IFM_59355-2	35	34	1	0	scaffold_3	3210258	3310258
Aspergillus_fumigatus_IFM_59355-2	38	34	4	0	scaffold_2	824126	924126
Aspergillus_fumigatus_IFM_59355-2	35	33	2	0	scaffold_3	3186893	3286893
Aspergillus_fumigatus_IFM_59355-2	38	34	4	0	scaffold_8	1595396	1695396
Aspergillus_fumigatus_IFM_59355-2	30	28	2	0	scaffold_2	4343422	4443422
Aspergillus_fumigatus_IFM_59355-2	38	34	4	0	scaffold_3	279445	379445
Aspergillus_fumigatus_IFM_59355-2	25	22	3	0	scaffold_1	1987694	2087694
Aspergillus_fumigatus_IFM_59355-2	46	42	4	0	scaffold_3	518219	618219
Aspergillus_fumigatus_IFM_59355-2	33	30	3	0	scaffold_6	2647826	2747826
Aspergillus_fumigatus_IFM_59355-2	41	34	7	0	scaffold_4	1491528	1591528
Aspergillus_fumigatus_IFM_59355-2	31	30	1	0	scaffold_3	1578689	1678689
Aspergillus_fumigatus_IFM_59355-2	37	35	2	0	scaffold_5	1740074	1840074
Aspergillus_fumigatus_IFM_59355-2	31	28	3	0	scaffold_5	2127905	2227905
Aspergillus_fumigatus_IFM_59355-2	38	34	4	0	scaffold_1	3828724	3928724
Aspergillus_fumigatus_IFM_59355-2	36	35	1	0	scaffold_3	3175705	3275705
Aspergillus_fumigatus_IFM_59355-2	42	36	6	0	scaffold_4	128545	228545
Aspergillus_fumigatus_IFM_59355-2	43	42	1	0	scaffold_5	2892398	2992398
Aspergillus_fumigatus_IFM_59355-2	35	33	2	0	scaffold_2	2980191	3080191
Aspergillus_fumigatus_IFM_59355-2	36	35	1	0	scaffold_4	2549723	2649723
Aspergillus_fumigatus_IFM_59355-2	32	30	2	0	scaffold_7	749705	849705
Aspergillus_fumigatus_IFM_59355-2	45	41	4	0	scaffold_3	517328	617328
Aspergillus_fumigatus_IFM_59355-2	42	37	5	0	scaffold_2	3174914	3274914
Aspergillus_fumigatus_IFM_59355-2	42	40	2	0	scaffold_6	3486052	3586052
Aspergillus_fumigatus_IFM_59355-2	32	28	4	0	scaffold_4	3279733	3379733
Aspergillus_fumigatus_IFM_59355-2	38	36	2	0	scaffold_6	975638	1075638
Aspergillus_fumigatus_IFM_59355-2	33	28	5	0	scaffold_7	629290	729290
Aspergillus_fumigatus_IFM_59355-2	39	37	2	0	scaffold_4	1132200	1232200
Aspergillus_fumigatus_IFM_59355-2	31	30	1	0	scaffold_1	1478630	1578630
Aspergillus_fumigatus_IFM_59355-2	32	30	2	0	scaffold_1	3062350	3162350
Aspergillus_fumigatus_IFM_59355-2	36	35	1	0	scaffold_2	610009	710009
Aspergillus_fumigatus_IFM_59355-2	41	35	6	0	scaffold_3	41946	141946
Aspergillus_fumigatus_IFM_59355-2	40	32	8	0	scaffold_1	4178953	4278953
Aspergillus_fumigatus_IFM_59355-2	34	26	8	0	scaffold_5	252604	352604
Aspergillus_fumigatus_IFM_59355-2	36	34	2	0	scaffold_3	2224516	2324516
Aspergillus_fumigatus_IFM_59355-2	36	34	2	0	scaffold_5	1298493	1398493
Aspergillus_fumigatus_IFM_59355-2	34	32	2	0	scaffold_1	1222000	1322000
Aspergillus_fumigatus_IFM_59355-2	46	43	3	0	scaffold_3	164725	264725
Aspergillus_fumigatus_IFM_59355-2	38	35	3	0	scaffold_2	4273874	4373874
Aspergillus_fumigatus_IFM_59355-2	40	34	6	0	scaffold_1	3935804	4035804
Aspergillus_fumigatus_IFM_59355-2	32	29	3	0	scaffold_1	1497815	1597815
Aspergillus_fumigatus_IFM_59355-2	37	35	2	0	scaffold_2	123987	223987
Aspergillus_fumigatus_IFM_59355-2	33	33	0	0	scaffold_4	511785	611785
Aspergillus_fumigatus_IFM_59355-2	39	36	3	0	scaffold_5	2536989	2636989
Aspergillus_fumigatus_IFM_59355-2	30	28	2	0	scaffold_4	1356823	1456823
Aspergillus_fumigatus_IFM_59355-2	35	32	3	0	scaffold_2	4239102	4339102
Aspergillus_fumigatus_IFM_59355-2	42	39	3	0	scaffold_3	2403454	2503454
Aspergillus_fumigatus_IFM_59355-2	44	41	3	0	scaffold_3	397221	497221
Aspergillus_fumigatus_IFM_59355-2	35	31	4	0	scaffold_4	1596371	1696371
Aspergillus_fumigatus_IFM_59355-2	36	33	3	0	scaffold_2	101581	201581
Aspergillus_fumigatus_IFM_59355-2	23	21	2	0	scaffold_1	1693909	1793909
Aspergillus_fumigatus_IFM_59355-2	20	18	2	0	scaffold_7	907953	1007953
Aspergillus_fumigatus_IFM_59355-2	32	18	14	0	scaffold_5	135683	235683
Aspergillus_fumigatus_IFM_59355-2	44	40	4	0	scaffold_6	3448407	3548407
Aspergillus_fumigatus_IFM_59355-2	35	34	1	0	scaffold_7	672066	772066
Aspergillus_fumigatus_IFM_59355-2	38	14	24	0	scaffold_1	4303676	4403676
Aspergillus_fumigatus_IFM_59355-2	38	37	1	0	scaffold_4	383510	483510
Aspergillus_fumigatus_IFM_59355-2	39	38	1	0	scaffold_5	2866117	2966117
Aspergillus_fumigatus_IFM_59355-2	18	17	1	0	scaffold_1	1735389	1835389
Aspergillus_fumigatus_IFM_59355-2	17	1	16	0	scaffold_8	1773171	1873171
Aspergillus_fumigatus_IFM_59355-2	36	30	6	0	scaffold_1	3919139	4019139
Aspergillus_fumigatus_IFM_59355-2	37	35	2	0	scaffold_5	866038	966038
Aspergillus_fumigatus_IFM_59355-2	34	33	1	0	scaffold_6	3194467	3294467
Aspergillus_fumigatus_IFM_59355-2	31	27	4	0	scaffold_4	2056673	2156673
Aspergillus_fumigatus_IFM_59355-2	13	12	1	0	scaffold_6	2143627	2243627
Aspergillus_fumigatus_IFM_59355-2	50	43	7	0	scaffold_5	3402125	3502125
Aspergillus_fumigatus_IFM_59355-2	39	35	4	0	scaffold_7	1330416	1430416
Aspergillus_fumigatus_IFM_59355-2	45	37	8	0	scaffold_4	16936	116936
Aspergillus_fumigatus_IFM_59355-2	49	46	3	0	scaffold_5	768013	868013
Aspergillus_fumigatus_IFM_59355-2	31	25	6	0	scaffold_5	208283	308283
Aspergillus_fumigatus_IFM_59355-2	47	36	11	0	scaffold_3	3636255	3736255
Aspergillus_fumigatus_IFM_59355-2	31	29	2	0	scaffold_4	622141	722141
Aspergillus_fumigatus_IFM_59355-2	38	35	3	0	scaffold_7	1369082	1469082
Aspergillus_fumigatus_IFM_59355-2	34	30	4	0	scaffold_6	1905474	2005474
Aspergillus_fumigatus_IFM_59355-2	30	28	2	0	scaffold_3	2208561	2308561
Aspergillus_fumigatus_IFM_59355-2	46	38	8	0	scaffold_8	204038	304038
Aspergillus_fumigatus_IFM_59355-2	38	34	4	0	scaffold_1	3153626	3253626
Aspergillus_fumigatus_IFM_59355-2	21	18	3	0	scaffold_8	749125	849125
Aspergillus_fumigatus_IFM_59355-2	27	23	4	0	scaffold_5	2408632	2508632
Aspergillus_fumigatus_IFM_59355-2	35	32	3	0	scaffold_1	1538067	1638067
Aspergillus_fumigatus_IFM_59355-2	33	14	19	0	scaffold_5	64722	164722
Aspergillus_fumigatus_IFM_59355-2	42	34	8	0	scaffold_3	1182025	1282025
Aspergillus_fumigatus_IFM_59355-2	31	28	3	0	scaffold_1	1126352	1226352
Aspergillus_fumigatus_IFM_59355-2	9	8	1	0	scaffold_1	2856452	2956452
Aspergillus_fumigatus_IFM_59355-2	41	39	2	0	scaffold_6	2577769	2677769
Aspergillus_fumigatus_IFM_59355-2	36	35	1	0	scaffold_2	1516561	1616561
Aspergillus_fumigatus_IFM_59355-2	42	40	2	0	scaffold_5	1904293	2004293
Aspergillus_fumigatus_IFM_59355-2	32	8	24	0	scaffold_5	101875	201875
Aspergillus_fumigatus_IFM_59355-2	19	1	18	0	scaffold_8	1729000	1829000
Aspergillus_fumigatus_IFM_59355-2	41	33	8	0	scaffold_6	2233878	2333878
Aspergillus_fumigatus_IFM_59355-2	31	23	8	0	scaffold_7	808078	908078
Aspergillus_fumigatus_IFM_59355-2	39	32	7	0	scaffold_1	4166340	4266340
Aspergillus_fumigatus_IFM_59355-2	45	37	8	0	scaffold_8	198511	298511
Aspergillus_fumigatus_IFM_59355-2	35	32	3	0	scaffold_7	181863	281863
Aspergillus_fumigatus_IFM_59355-2	43	42	1	0	scaffold_3	3897112	3997112
Aspergillus_fumigatus_IFM_59355-2	38	37	1	0	scaffold_4	2173208	2273208
Aspergillus_fumigatus_IFM_59355-2	11	10	1	0	scaffold_6	1225431	1325431
Aspergillus_fumigatus_IFM_59355-2	37	35	2	0	scaffold_5	1732445	1832445
Aspergillus_fumigatus_IFM_59355-2	38	29	9	0	scaffold_6	2835967	2935967
Aspergillus_fumigatus_IFM_59355-2	34	33	1	0	scaffold_4	1150528	1250528
Aspergillus_fumigatus_IFM_59355-2	41	37	4	0	scaffold_6	1123912	1223912
Aspergillus_fumigatus_IFM_59355-2	35	34	1	0	scaffold_3	2905177	3005177
Aspergillus_fumigatus_IFM_59355-2	43	42	1	0	scaffold_6	574628	674628
Aspergillus_fumigatus_IFM_59355-2	29	22	7	0	scaffold_2	2503631	2603631
Aspergillus_fumigatus_IFM_59355-2	44	35	9	0	scaffold_1	125897	225897
Aspergillus_fumigatus_IFM_59355-2	44	43	1	0	scaffold_5	2300993	2400993
Aspergillus_fumigatus_IFM_59355-2	41	40	1	0	scaffold_4	171351	271351
Aspergillus_fumigatus_IFM_59355-2	33	33	0	0	scaffold_2	668872	768872
Aspergillus_fumigatus_IFM_59355-2	37	31	6	0	scaffold_7	377656	477656
Aspergillus_fumigatus_IFM_59355-2	31	30	1	0	scaffold_1	1251737	1351737
Aspergillus_fumigatus_IFM_59355-2	36	33	3	0	scaffold_6	3338328	3438328
Aspergillus_fumigatus_IFM_59355-2	44	39	5	0	scaffold_3	145589	245589
Aspergillus_fumigatus_IFM_59355-2	34	15	19	0	scaffold_3	747979	847979
Aspergillus_fumigatus_IFM_59355-2	36	34	2	0	scaffold_2	292937	392937
Aspergillus_fumigatus_IFM_59355-2	38	36	2	0	scaffold_3	3129959	3229959
Aspergillus_fumigatus_IFM_59355-2	14	14	0	0	scaffold_5	1142157	1242157
Aspergillus_fumigatus_IFM_59355-2	33	31	2	0	scaffold_4	1413304	1513304
Aspergillus_fumigatus_IFM_59355-2	44	36	8	0	scaffold_3	1189630	1289630
Aspergillus_fumigatus_IFM_59355-2	44	43	1	0	scaffold_4	863929	963929
Aspergillus_fumigatus_IFM_59355-2	37	36	1	0	scaffold_5	3090282	3190282
Aspergillus_fumigatus_IFM_59355-2	36	36	0	0	scaffold_5	1550888	1650888
Aspergillus_fumigatus_IFM_59355-2	38	33	5	0	scaffold_2	798498	898498
Aspergillus_fumigatus_IFM_59355-2	38	34	4	0	scaffold_5	567514	667514
Aspergillus_fumigatus_IFM_59355-2	37	25	12	0	scaffold_1	4332605	4432605
Aspergillus_fumigatus_IFM_59355-2	24	18	6	0	scaffold_6	170422	270422
Aspergillus_fumigatus_IFM_59355-2	48	42	6	0	scaffold_4	3659650	3759650
Aspergillus_fumigatus_IFM_59355-2	41	37	4	0	scaffold_4	2425415	2525415
Aspergillus_fumigatus_IFM_59355-2	36	35	1	0	scaffold_2	4085476	4185476
Aspergillus_fumigatus_IFM_59355-2	32	28	4	0	scaffold_2	1022946	1122946
Aspergillus_fumigatus_IFM_59355-2	40	36	4	0	scaffold_2	3381186	3481186
Aspergillus_fumigatus_IFM_59355-2	37	30	7	0	scaffold_2	2558892	2658892
Aspergillus_fumigatus_IFM_59355-2	32	30	2	0	scaffold_3	2181219	2281219
Aspergillus_fumigatus_IFM_59355-2	31	31	0	0	scaffold_5	3027137	3127137
Aspergillus_fumigatus_IFM_59355-2	29	4	25	0	scaffold_3	662857	762857
Aspergillus_fumigatus_IFM_59355-2	44	37	7	0	scaffold_8	1117272	1217272
Aspergillus_fumigatus_IFM_59355-2	35	34	1	0	scaffold_6	926010	1026010
Aspergillus_fumigatus_IFM_59355-2	41	39	2	0	scaffold_6	624090	724090
Aspergillus_fumigatus_IFM_59355-2	41	36	5	0	scaffold_2	1676118	1776118
Aspergillus_fumigatus_IFM_59355-2	33	32	1	0	scaffold_5	2101374	2201374
Aspergillus_fumigatus_IFM_59355-2	48	41	7	0	scaffold_5	3635853	3735853
Aspergillus_fumigatus_IFM_59355-2	43	39	4	0	scaffold_7	1974740	2074740
Aspergillus_fumigatus_IFM_59355-2	36	34	2	0	scaffold_5	1730318	1830318
Aspergillus_fumigatus_IFM_59355-2	34	31	3	0	scaffold_6	3345045	3445045
Aspergillus_fumigatus_IFM_59355-2	31	28	3	0	scaffold_1	1120752	1220752
Aspergillus_fumigatus_IFM_59355-2	31	29	2	0	scaffold_7	1486455	1586455
Aspergillus_fumigatus_IFM_59355-2	35	30	5	0	scaffold_1	3416576	3516576
Aspergillus_fumigatus_IFM_59355-2	39	30	9	0	scaffold_5	2240633	2340633
Aspergillus_fumigatus_IFM_59355-2	42	37	5	0	scaffold_5	725082	825082
Aspergillus_fumigatus_IFM_59355-2	32	32	0	0	scaffold_5	3031484	3131484
Aspergillus_fumigatus_IFM_59355-2	32	32	0	0	scaffold_6	3181875	3281875
Aspergillus_fumigatus_IFM_59355-2	29	28	1	0	scaffold_2	3724422	3824422
Aspergillus_fumigatus_IFM_59355-2	33	31	2	0	scaffold_3	1532078	1632078
Aspergillus_fumigatus_IFM_59355-2	39	35	4	0	scaffold_6	1344631	1444631
Aspergillus_fumigatus_IFM_59355-2	30	28	2	0	scaffold_5	2675905	2775905
Aspergillus_fumigatus_IFM_59355-2	35	34	1	0	scaffold_7	1053481	1153481
Aspergillus_fumigatus_IFM_59355-2	40	36	4	0	scaffold_1	4420040	4520040
Aspergillus_fumigatus_IFM_59355-2	21	1	20	0	scaffold_8	1741678	1841678
Aspergillus_fumigatus_IFM_59355-2	42	40	2	0	scaffold_2	2136760	2236760
Aspergillus_fumigatus_IFM_59355-2	30	28	2	0	scaffold_3	2999152	3099152
Aspergillus_fumigatus_IFM_59355-2	42	39	3	0	scaffold_2	2818797	2918797
Aspergillus_fumigatus_IFM_59355-2	33	31	2	0	scaffold_6	1406644	1506644
Aspergillus_fumigatus_IFM_59355-2	42	38	4	0	scaffold_4	2417088	2517088
Aspergillus_fumigatus_IFM_59355-2	30	26	4	0	scaffold_4	2044085	2144085
Aspergillus_fumigatus_IFM_59355-2	41	38	3	0	scaffold_7	102189	202189
Aspergillus_fumigatus_IFM_59355-2	26	26	0	0	scaffold_5	2786564	2886564
Aspergillus_fumigatus_IFM_59355-2	40	40	0	0	scaffold_2	1394673	1494673
Aspergillus_fumigatus_IFM_59355-2	38	38	0	0	scaffold_5	1345504	1445504
Aspergillus_fumigatus_IFM_59355-2	49	42	7	0	scaffold_5	3407351	3507351
Aspergillus_fumigatus_IFM_59355-2	34	33	1	0	scaffold_2	722524	822524
Aspergillus_fumigatus_IFM_59355-2	31	29	2	0	scaffold_7	1497966	1597966
Aspergillus_fumigatus_IFM_59355-2	47	35	12	0	scaffold_1	56559	156559
Aspergillus_fumigatus_IFM_59355-2	38	34	4	0	scaffold_6	1503808	1603808
Aspergillus_fumigatus_IFM_59355-2	42	36	6	0	scaffold_6	2786927	2886927
Aspergillus_fumigatus_IFM_59355-2	39	35	4	0	scaffold_8	483739	583739
Aspergillus_fumigatus_IFM_59355-2	44	40	4	0	scaffold_3	3592073	3692073
Aspergillus_fumigatus_IFM_59355-2	41	39	2	0	scaffold_4	366688	466688
Aspergillus_fumigatus_IFM_59355-2	25	19	6	0	scaffold_6	171015	271015
Aspergillus_fumigatus_IFM_59355-2	33	31	2	0	scaffold_8	1219582	1319582
Aspergillus_fumigatus_IFM_59355-2	29	28	1	0	scaffold_4	1189019	1289019
Aspergillus_fumigatus_IFM_59355-2	39	36	3	0	scaffold_6	1511675	1611675
Aspergillus_fumigatus_IFM_59355-2	38	31	7	0	scaffold_8	1084225	1184225
Aspergillus_fumigatus_IFM_59355-2	34	31	3	0	scaffold_6	303204	403204
Aspergillus_fumigatus_IFM_59355-2	36	35	1	0	scaffold_7	1446283	1546283
Aspergillus_fumigatus_IFM_59355-2	38	36	2	0	scaffold_2	2102717	2202717
Aspergillus_fumigatus_IFM_59355-2	40	35	5	0	scaffold_4	2321898	2421898
Aspergillus_fumigatus_IFM_59355-2	34	27	7	0	scaffold_1	3470484	3570484
Aspergillus_fumigatus_IFM_59355-2	32	32	0	0	scaffold_2	708952	808952
Aspergillus_fumigatus_IFM_59355-2	38	35	3	0	scaffold_1	809825	909825
Aspergillus_fumigatus_IFM_59355-2	31	30	1	0	scaffold_5	1413905	1513905
Aspergillus_fumigatus_IFM_59355-2	36	29	7	0	scaffold_2	3919535	4019535
Aspergillus_fumigatus_IFM_59355-2	43	41	2	0	scaffold_5	828493	928493
Aspergillus_fumigatus_IFM_59355-2	39	33	6	0	scaffold_7	1914775	2014775
Aspergillus_fumigatus_IFM_59355-2	35	33	2	0	scaffold_4	1290313	1390313
Aspergillus_fumigatus_IFM_59355-2	14	13	1	0	scaffold_6	2134832	2234832
Aspergillus_fumigatus_IFM_59355-2	35	33	2	0	scaffold_1	3022037	3122037
Aspergillus_fumigatus_IFM_59355-2	40	36	4	0	scaffold_3	3515146	3615146
Aspergillus_fumigatus_IFM_59355-2	42	38	4	0	scaffold_2	1331071	1431071
Aspergillus_fumigatus_IFM_59355-2	36	11	25	0	scaffold_3	719035	819035
Aspergillus_fumigatus_IFM_59355-2	32	30	2	0	scaffold_4	1409074	1509074
Aspergillus_fumigatus_IFM_59355-2	36	32	4	0	scaffold_3	2611279	2711279
Aspergillus_fumigatus_IFM_59355-2	42	37	5	0	scaffold_3	3579251	3679251
Aspergillus_fumigatus_IFM_59355-2	40	36	4	0	scaffold_2	3480484	3580484
Aspergillus_fumigatus_IFM_59355-2	36	36	0	0	scaffold_5	2971154	3071154
Aspergillus_fumigatus_IFM_59355-2	29	26	3	0	scaffold_4	1764511	1864511
Aspergillus_fumigatus_IFM_59355-2	34	30	4	0	scaffold_6	2930144	3030144
Aspergillus_fumigatus_IFM_59355-2	35	32	3	0	scaffold_2	781838	881838
Aspergillus_fumigatus_IFM_59355-2	12	10	2	0	scaffold_3	1403640	1503640
Aspergillus_fumigatus_IFM_59355-2	35	32	3	0	scaffold_1	1529982	1629982
Aspergillus_fumigatus_IFM_59355-2	40	36	4	0	scaffold_2	4119936	4219936
Aspergillus_fumigatus_IFM_59355-2	34	32	2	0	scaffold_1	3691120	3791120
Aspergillus_fumigatus_IFM_59355-2	35	31	4	0	scaffold_6	1490972	1590972
Aspergillus_fumigatus_IFM_59355-2	29	29	0	0	scaffold_8	598198	698198
Aspergillus_fumigatus_IFM_59355-2	39	35	4	0	scaffold_1	3111683	3211683
Aspergillus_fumigatus_IFM_59355-2	38	37	1	0	scaffold_5	1364719	1464719
Aspergillus_fumigatus_IFM_59355-2	33	31	2	0	scaffold_4	586299	686299
Aspergillus_fumigatus_IFM_59355-2	32	26	6	0	scaffold_3	3771230	3871230
Aspergillus_fumigatus_IFM_59355-2	41	38	3	0	scaffold_3	4043784	4143784
Aspergillus_fumigatus_IFM_59355-2	36	32	4	0	scaffold_6	413114	513114
Aspergillus_fumigatus_IFM_59355-2	34	34	0	0	scaffold_3	1936366	2036366
Aspergillus_fumigatus_IFM_59355-2	49	40	9	0	scaffold_4	3628275	3728275
Aspergillus_fumigatus_IFM_59355-2	34	31	3	0	scaffold_8	1269588	1369588
Aspergillus_fumigatus_IFM_59355-2	37	37	0	0	scaffold_4	3003418	3103418
Aspergillus_fumigatus_IFM_59355-2	43	39	4	0	scaffold_1	4528276	4628276
Aspergillus_fumigatus_IFM_59355-2	41	39	2	0	scaffold_6	2015197	2115197
Aspergillus_fumigatus_IFM_59355-2	33	32	1	0	scaffold_8	1407280	1507280
Aspergillus_fumigatus_IFM_59355-2	41	38	3	0	scaffold_2	2060905	2160905
Aspergillus_fumigatus_IFM_59355-2	37	37	0	0	scaffold_6	3100350	3200350
Aspergillus_fumigatus_IFM_59355-2	36	34	2	0	scaffold_2	2947669	3047669
Aspergillus_fumigatus_IFM_59355-2	38	37	1	0	scaffold_5	2859614	2959614
Aspergillus_fumigatus_IFM_59355-2	26	26	0	0	scaffold_5	2782916	2882916
Aspergillus_fumigatus_IFM_59355-2	30	27	3	0	scaffold_1	1975167	2075167
Aspergillus_fumigatus_IFM_59355-2	38	36	2	0	scaffold_4	1130675	1230675
Aspergillus_fumigatus_IFM_59355-2	34	30	4	0	scaffold_4	1607089	1707089
Aspergillus_fumigatus_IFM_59355-2	33	31	2	0	scaffold_6	1728771	1828771
Aspergillus_fumigatus_IFM_59355-2	40	34	6	0	scaffold_3	60951	160951
Aspergillus_fumigatus_IFM_59355-2	31	6	25	0	scaffold_3	935597	1035597
Aspergillus_fumigatus_IFM_59355-2	21	21	0	0	scaffold_8	640681	740681
Aspergillus_fumigatus_IFM_59355-2	43	34	9	0	scaffold_1	147109	247109
