STRAIN	TOTAL	CORE	ACCESSORY	SINGLETON	CHROM	START	END
Aspergillus_fumigatus_A1159	20	19	1	0	scaffold_5	2479356	2529356
Aspergillus_fumigatus_A1159	17	15	2	0	scaffold_1	3644890	3694890
Aspergillus_fumigatus_A1159	15	14	1	0	scaffold_2	4265444	4315444
Aspergillus_fumigatus_A1159	17	9	8	0	scaffold_1	4475295	4525295
Aspergillus_fumigatus_A1159	19	17	2	0	scaffold_5	2638183	2688183
Aspergillus_fumigatus_A1159	21	18	3	0	scaffold_3	3860266	3910266
Aspergillus_fumigatus_A1159	20	18	2	0	scaffold_4	2084269	2134269
Aspergillus_fumigatus_A1159	16	16	0	0	scaffold_3	3325508	3375508
Aspergillus_fumigatus_A1159	14	14	0	0	scaffold_1	2939770	2989770
Aspergillus_fumigatus_A1159	16	15	1	0	scaffold_4	1791841	1841841
Aspergillus_fumigatus_A1159	24	21	3	0	scaffold_3	2201046	2251046
Aspergillus_fumigatus_A1159	19	15	4	0	scaffold_1	3143837	3193837
Aspergillus_fumigatus_A1159	2	1	1	0	scaffold_7	930764	980764
Aspergillus_fumigatus_A1159	18	15	3	0	scaffold_4	991261	1041261
Aspergillus_fumigatus_A1159	23	22	1	0	scaffold_4	3602087	3652087
Aspergillus_fumigatus_A1159	21	20	1	0	scaffold_8	1207603	1257603
Aspergillus_fumigatus_A1159	16	16	0	0	scaffold_3	1518784	1568784
Aspergillus_fumigatus_A1159	23	21	2	0	scaffold_5	41989	91989
Aspergillus_fumigatus_A1159	4	3	1	0	scaffold_8	565759	615759
Aspergillus_fumigatus_A1159	17	15	2	0	scaffold_3	3688695	3738695
Aspergillus_fumigatus_A1159	12	11	1	0	scaffold_7	885074	935074
Aspergillus_fumigatus_A1159	17	17	0	0	scaffold_6	685231	735231
Aspergillus_fumigatus_A1159	16	14	2	0	scaffold_7	1040090	1090090
Aspergillus_fumigatus_A1159	21	20	1	0	scaffold_6	714237	764237
Aspergillus_fumigatus_A1159	21	19	2	0	scaffold_2	2704193	2754193
Aspergillus_fumigatus_A1159	19	18	1	0	scaffold_1	2280601	2330601
Aspergillus_fumigatus_A1159	19	15	4	0	scaffold_1	4089886	4139886
Aspergillus_fumigatus_A1159	17	17	0	0	scaffold_4	3676134	3726134
Aspergillus_fumigatus_A1159	2	1	1	0	scaffold_7	930276	980276
Aspergillus_fumigatus_A1159	21	20	1	0	scaffold_5	459791	509791
Aspergillus_fumigatus_A1159	19	16	3	0	scaffold_7	23336	73336
Aspergillus_fumigatus_A1159	17	14	3	0	scaffold_3	2563264	2613264
Aspergillus_fumigatus_A1159	19	16	3	0	scaffold_2	1134264	1184264
Aspergillus_fumigatus_A1159	19	19	0	0	scaffold_5	496431	546431
Aspergillus_fumigatus_A1159	24	22	2	0	scaffold_5	54462	104462
Aspergillus_fumigatus_A1159	13	12	1	0	scaffold_3	3287833	3337833
Aspergillus_fumigatus_A1159	21	18	3	0	scaffold_1	4645246	4695246
Aspergillus_fumigatus_A1159	23	21	2	0	scaffold_2	2030363	2080363
Aspergillus_fumigatus_A1159	20	19	1	0	scaffold_4	1153377	1203377
Aspergillus_fumigatus_A1159	21	20	1	0	scaffold_4	2475072	2525072
Aspergillus_fumigatus_A1159	22	22	0	0	scaffold_1	3544651	3594651
Aspergillus_fumigatus_A1159	21	19	2	0	scaffold_6	733388	783388
Aspergillus_fumigatus_A1159	14	11	3	0	scaffold_6	323311	373311
Aspergillus_fumigatus_A1159	0	0	0	0	scaffold_1	1759401	1809401
Aspergillus_fumigatus_A1159	20	17	3	0	scaffold_1	3048514	3098514
Aspergillus_fumigatus_A1159	0	0	0	0	scaffold_6	997385	1047385
Aspergillus_fumigatus_A1159	8	7	1	0	scaffold_1	1680588	1730588
Aspergillus_fumigatus_A1159	22	19	3	0	scaffold_1	4577365	4627365
Aspergillus_fumigatus_A1159	16	14	2	0	scaffold_7	1285069	1335069
Aspergillus_fumigatus_A1159	25	24	1	0	scaffold_6	588469	638469
Aspergillus_fumigatus_A1159	17	14	3	0	scaffold_4	379127	429127
Aspergillus_fumigatus_A1159	19	17	2	0	scaffold_4	927386	977386
Aspergillus_fumigatus_A1159	20	16	4	0	scaffold_5	2299178	2349178
Aspergillus_fumigatus_A1159	16	15	1	0	scaffold_3	1557110	1607110
Aspergillus_fumigatus_A1159	22	22	0	0	scaffold_2	317055	367055
Aspergillus_fumigatus_A1159	19	16	3	0	scaffold_4	2707492	2757492
Aspergillus_fumigatus_A1159	20	18	2	0	scaffold_4	2797830	2847830
Aspergillus_fumigatus_A1159	15	14	1	0	scaffold_2	2756993	2806993
Aspergillus_fumigatus_A1159	22	21	1	0	scaffold_6	1736437	1786437
Aspergillus_fumigatus_A1159	19	18	1	0	scaffold_3	1573834	1623834
Aspergillus_fumigatus_A1159	18	17	1	0	scaffold_1	1261586	1311586
Aspergillus_fumigatus_A1159	22	15	7	0	scaffold_4	2950105	3000105
Aspergillus_fumigatus_A1159	26	21	5	0	scaffold_3	3912824	3962824
Aspergillus_fumigatus_A1159	23	17	6	0	scaffold_7	1718036	1768036
Aspergillus_fumigatus_A1159	17	15	2	0	scaffold_3	2275350	2325350
Aspergillus_fumigatus_A1159	21	18	3	0	scaffold_2	1425699	1475699
Aspergillus_fumigatus_A1159	19	18	1	0	scaffold_5	1359821	1409821
Aspergillus_fumigatus_A1159	17	17	0	0	scaffold_1	2308345	2358345
Aspergillus_fumigatus_A1159	17	10	7	0	scaffold_3	3993840	4043840
Aspergillus_fumigatus_A1159	16	16	0	0	scaffold_5	849697	899697
Aspergillus_fumigatus_A1159	9	8	1	0	scaffold_2	4615345	4665345
Aspergillus_fumigatus_A1159	18	15	3	0	scaffold_1	278347	328347
Aspergillus_fumigatus_A1159	29	24	5	0	scaffold_6	3216508	3266508
Aspergillus_fumigatus_A1159	16	15	1	0	scaffold_5	2762186	2812186
Aspergillus_fumigatus_A1159	18	18	0	0	scaffold_2	954121	1004121
Aspergillus_fumigatus_A1159	18	16	2	0	scaffold_4	1020249	1070249
Aspergillus_fumigatus_A1159	10	9	1	0	scaffold_7	900138	950138
Aspergillus_fumigatus_A1159	20	18	2	0	scaffold_4	941043	991043
Aspergillus_fumigatus_A1159	18	17	1	0	scaffold_3	3507101	3557101
Aspergillus_fumigatus_A1159	19	17	2	0	scaffold_6	3305423	3355423
Aspergillus_fumigatus_A1159	19	17	2	0	scaffold_3	3034698	3084698
Aspergillus_fumigatus_A1159	18	16	2	0	scaffold_8	728080	778080
Aspergillus_fumigatus_A1159	16	14	2	0	scaffold_4	1824426	1874426
Aspergillus_fumigatus_A1159	17	16	1	0	scaffold_2	1381263	1431263
Aspergillus_fumigatus_A1159	20	18	2	0	scaffold_1	2779686	2829686
Aspergillus_fumigatus_A1159	21	0	21	0	scaffold_1	4356221	4406221
Aspergillus_fumigatus_A1159	20	16	4	0	scaffold_8	143519	193519
Aspergillus_fumigatus_A1159	16	16	0	0	scaffold_2	2405125	2455125
Aspergillus_fumigatus_A1159	16	15	1	0	scaffold_2	528661	578661
Aspergillus_fumigatus_A1159	18	16	2	0	scaffold_3	3228605	3278605
Aspergillus_fumigatus_A1159	23	22	1	0	scaffold_2	190959	240959
Aspergillus_fumigatus_A1159	13	12	1	0	scaffold_1	2846614	2896614
Aspergillus_fumigatus_A1159	17	16	1	0	scaffold_3	1630643	1680643
Aspergillus_fumigatus_A1159	23	21	2	0	scaffold_8	905237	955237
Aspergillus_fumigatus_A1159	20	19	1	0	scaffold_4	1555289	1605289
Aspergillus_fumigatus_A1159	14	0	14	0	scaffold_1	4266725	4316725
Aspergillus_fumigatus_A1159	13	10	3	0	scaffold_4	145361	195361
Aspergillus_fumigatus_A1159	15	14	1	0	scaffold_8	813475	863475
Aspergillus_fumigatus_A1159	14	14	0	0	scaffold_5	1187768	1237768
Aspergillus_fumigatus_A1159	19	17	2	0	scaffold_4	655040	705040
Aspergillus_fumigatus_A1159	17	17	0	0	scaffold_2	3626750	3676750
Aspergillus_fumigatus_A1159	29	25	4	0	scaffold_3	4313419	4363419
Aspergillus_fumigatus_A1159	18	17	1	0	scaffold_5	1655102	1705102
Aspergillus_fumigatus_A1159	18	16	2	0	scaffold_7	804700	854700
Aspergillus_fumigatus_A1159	16	16	0	0	scaffold_1	1104983	1154983
Aspergillus_fumigatus_A1159	18	18	0	0	scaffold_4	1966799	2016799
Aspergillus_fumigatus_A1159	16	16	0	0	scaffold_7	1429965	1479965
Aspergillus_fumigatus_A1159	13	12	1	0	scaffold_7	882863	932863
Aspergillus_fumigatus_A1159	14	13	1	0	scaffold_2	3115929	3165929
Aspergillus_fumigatus_A1159	18	15	3	0	scaffold_1	4550649	4600649
Aspergillus_fumigatus_A1159	20	19	1	0	scaffold_2	3231477	3281477
Aspergillus_fumigatus_A1159	19	17	2	0	scaffold_3	2268911	2318911
Aspergillus_fumigatus_A1159	19	19	0	0	scaffold_5	2090473	2140473
Aspergillus_fumigatus_A1159	17	14	3	0	scaffold_3	2385108	2435108
Aspergillus_fumigatus_A1159	22	20	2	0	scaffold_1	13737	63737
Aspergillus_fumigatus_A1159	19	16	3	0	scaffold_3	1339205	1389205
Aspergillus_fumigatus_A1159	14	5	9	0	scaffold_3	570093	620093
Aspergillus_fumigatus_A1159	17	15	2	0	scaffold_2	409042	459042
Aspergillus_fumigatus_A1159	19	19	0	0	scaffold_6	1372851	1422851
Aspergillus_fumigatus_A1159	18	17	1	0	scaffold_1	2508317	2558317
Aspergillus_fumigatus_A1159	19	18	1	0	scaffold_4	759097	809097
Aspergillus_fumigatus_A1159	21	20	1	0	scaffold_4	3192919	3242919
Aspergillus_fumigatus_A1159	17	16	1	0	scaffold_6	1596088	1646088
Aspergillus_fumigatus_A1159	20	20	0	0	scaffold_2	2443483	2493483
Aspergillus_fumigatus_A1159	22	20	2	0	scaffold_8	56432	106432
Aspergillus_fumigatus_A1159	20	19	1	0	scaffold_6	1761979	1811979
Aspergillus_fumigatus_A1159	21	19	2	0	scaffold_1	3456835	3506835
Aspergillus_fumigatus_A1159	22	21	1	0	scaffold_4	3526366	3576366
Aspergillus_fumigatus_A1159	20	18	2	0	scaffold_5	2227222	2277222
Aspergillus_fumigatus_A1159	12	11	1	0	scaffold_2	1881694	1931694
Aspergillus_fumigatus_A1159	22	19	3	0	scaffold_2	909924	959924
Aspergillus_fumigatus_A1159	18	18	0	0	scaffold_3	1512581	1562581
Aspergillus_fumigatus_A1159	14	12	2	0	scaffold_3	2351366	2401366
Aspergillus_fumigatus_A1159	21	21	0	0	scaffold_8	226272	276272
Aspergillus_fumigatus_A1159	20	20	0	0	scaffold_2	4037937	4087937
Aspergillus_fumigatus_A1159	14	13	1	0	scaffold_5	1321107	1371107
Aspergillus_fumigatus_A1159	11	10	1	0	scaffold_6	2322414	2372414
Aspergillus_fumigatus_A1159	22	20	2	0	scaffold_1	315080	365080
Aspergillus_fumigatus_A1159	28	23	5	0	scaffold_5	3578643	3628643
Aspergillus_fumigatus_A1159	17	17	0	0	scaffold_5	2956092	3006092
Aspergillus_fumigatus_A1159	16	16	0	0	scaffold_3	1965701	2015701
Aspergillus_fumigatus_A1159	18	14	4	0	scaffold_1	4094682	4144682
Aspergillus_fumigatus_A1159	24	23	1	0	scaffold_6	587696	637696
Aspergillus_fumigatus_A1159	25	20	5	0	scaffold_4	26017	76017
Aspergillus_fumigatus_A1159	22	22	0	0	scaffold_1	3539880	3589880
Aspergillus_fumigatus_A1159	15	14	1	0	scaffold_2	713543	763543
Aspergillus_fumigatus_A1159	15	15	0	0	scaffold_4	1679517	1729517
Aspergillus_fumigatus_A1159	17	17	0	0	scaffold_1	445193	495193
Aspergillus_fumigatus_A1159	22	18	4	0	scaffold_3	931017	981017
Aspergillus_fumigatus_A1159	27	23	4	0	scaffold_4	433046	483046
Aspergillus_fumigatus_A1159	17	17	0	0	scaffold_4	787087	837087
Aspergillus_fumigatus_A1159	18	18	0	0	scaffold_2	826655	876655
Aspergillus_fumigatus_A1159	21	21	0	0	scaffold_5	317688	367688
Aspergillus_fumigatus_A1159	20	19	1	0	scaffold_2	1500371	1550371
Aspergillus_fumigatus_A1159	18	17	1	0	scaffold_6	3110432	3160432
Aspergillus_fumigatus_A1159	19	18	1	0	scaffold_6	3103278	3153278
Aspergillus_fumigatus_A1159	23	0	23	0	scaffold_1	4389687	4439687
Aspergillus_fumigatus_A1159	20	17	3	0	scaffold_8	721821	771821
Aspergillus_fumigatus_A1159	25	21	4	0	scaffold_1	4624775	4674775
Aspergillus_fumigatus_A1159	27	23	4	0	scaffold_1	4606275	4656275
Aspergillus_fumigatus_A1159	22	21	1	0	scaffold_6	2119201	2169201
Aspergillus_fumigatus_A1159	19	11	8	0	scaffold_6	158909	208909
Aspergillus_fumigatus_A1159	19	18	1	0	scaffold_6	1776165	1826165
Aspergillus_fumigatus_A1159	18	16	2	0	scaffold_1	3213850	3263850
Aspergillus_fumigatus_A1159	17	17	0	0	scaffold_5	3235397	3285397
Aspergillus_fumigatus_A1159	13	12	1	0	scaffold_8	822933	872933
Aspergillus_fumigatus_A1159	14	12	2	0	scaffold_4	3094747	3144747
Aspergillus_fumigatus_A1159	18	16	2	0	scaffold_7	1268266	1318266
Aspergillus_fumigatus_A1159	17	16	1	0	scaffold_1	1828297	1878297
Aspergillus_fumigatus_A1159	23	19	4	0	scaffold_1	4017354	4067354
Aspergillus_fumigatus_A1159	11	10	1	0	scaffold_2	4618832	4668832
Aspergillus_fumigatus_A1159	23	21	2	0	scaffold_1	2457648	2507648
Aspergillus_fumigatus_A1159	21	18	3	0	scaffold_2	866376	916376
Aspergillus_fumigatus_A1159	17	14	3	0	scaffold_6	503372	553372
Aspergillus_fumigatus_A1159	20	17	3	0	scaffold_2	3418090	3468090
Aspergillus_fumigatus_A1159	16	15	1	0	scaffold_1	3714680	3764680
Aspergillus_fumigatus_A1159	18	16	2	0	scaffold_3	1247917	1297917
Aspergillus_fumigatus_A1159	22	19	3	0	scaffold_1	4644362	4694362
Aspergillus_fumigatus_A1159	16	16	0	0	scaffold_5	251326	301326
Aspergillus_fumigatus_A1159	20	20	0	0	scaffold_4	1968398	2018398
Aspergillus_fumigatus_A1159	20	19	1	0	scaffold_5	753516	803516
Aspergillus_fumigatus_A1159	21	16	5	0	scaffold_4	2542217	2592217
Aspergillus_fumigatus_A1159	21	19	2	0	scaffold_4	551338	601338
Aspergillus_fumigatus_A1159	17	15	2	0	scaffold_6	2198569	2248569
Aspergillus_fumigatus_A1159	17	16	1	0	scaffold_2	2897112	2947112
Aspergillus_fumigatus_A1159	17	16	1	0	scaffold_3	1176431	1226431
Aspergillus_fumigatus_A1159	29	22	7	0	scaffold_5	157009	207009
Aspergillus_fumigatus_A1159	20	16	4	0	scaffold_7	652068	702068
Aspergillus_fumigatus_A1159	11	8	3	0	scaffold_1	1948527	1998527
Aspergillus_fumigatus_A1159	17	15	2	0	scaffold_1	664422	714422
Aspergillus_fumigatus_A1159	20	19	1	0	scaffold_4	1247878	1297878
Aspergillus_fumigatus_A1159	15	12	3	0	scaffold_7	1544285	1594285
Aspergillus_fumigatus_A1159	22	18	4	0	scaffold_8	464048	514048
Aspergillus_fumigatus_A1159	19	17	2	0	scaffold_1	731310	781310
Aspergillus_fumigatus_A1159	20	20	0	0	scaffold_3	2739864	2789864
Aspergillus_fumigatus_A1159	27	23	4	0	scaffold_5	3558267	3608267
Aspergillus_fumigatus_A1159	21	18	3	0	scaffold_2	2236724	2286724
Aspergillus_fumigatus_A1159	25	18	7	0	scaffold_1	94873	144873
Aspergillus_fumigatus_A1159	21	20	1	0	scaffold_8	1166531	1216531
Aspergillus_fumigatus_A1159	12	11	1	0	scaffold_1	3227587	3277587
Aspergillus_fumigatus_A1159	13	12	1	0	scaffold_7	1008455	1058455
Aspergillus_fumigatus_A1159	16	15	1	0	scaffold_4	2762281	2812281
Aspergillus_fumigatus_A1159	23	22	1	0	scaffold_2	1528011	1578011
Aspergillus_fumigatus_A1159	16	13	3	0	scaffold_1	3701778	3751778
Aspergillus_fumigatus_A1159	6	5	1	0	scaffold_4	2224265	2274265
Aspergillus_fumigatus_A1159	17	15	2	0	scaffold_4	2393950	2443950
Aspergillus_fumigatus_A1159	19	18	1	0	scaffold_7	1199578	1249578
Aspergillus_fumigatus_A1159	22	19	3	0	scaffold_2	4517772	4567772
Aspergillus_fumigatus_A1159	19	18	1	0	scaffold_3	3454855	3504855
Aspergillus_fumigatus_A1159	12	12	0	0	scaffold_1	1404663	1454663
Aspergillus_fumigatus_A1159	23	21	2	0	scaffold_6	3146804	3196804
Aspergillus_fumigatus_A1159	24	22	2	0	scaffold_4	3570737	3620737
Aspergillus_fumigatus_A1159	24	22	2	0	scaffold_4	563310	613310
Aspergillus_fumigatus_A1159	22	20	2	0	scaffold_3	4225720	4275720
Aspergillus_fumigatus_A1159	22	14	8	0	scaffold_5	3401464	3451464
Aspergillus_fumigatus_A1159	11	11	0	0	scaffold_1	1398923	1448923
Aspergillus_fumigatus_A1159	10	10	0	0	scaffold_5	1817346	1867346
Aspergillus_fumigatus_A1159	21	21	0	0	scaffold_2	3537777	3587777
Aspergillus_fumigatus_A1159	15	7	8	0	scaffold_3	565685	615685
Aspergillus_fumigatus_A1159	17	15	2	0	scaffold_4	3109043	3159043
Aspergillus_fumigatus_A1159	18	16	2	0	scaffold_2	2249362	2299362
Aspergillus_fumigatus_A1159	21	20	1	0	scaffold_6	879238	929238
Aspergillus_fumigatus_A1159	23	23	0	0	scaffold_2	1464116	1514116
Aspergillus_fumigatus_A1159	11	10	1	0	scaffold_5	1995766	2045766
Aspergillus_fumigatus_A1159	14	14	0	0	scaffold_5	1005860	1055860
Aspergillus_fumigatus_A1159	15	13	2	0	scaffold_4	1819958	1869958
Aspergillus_fumigatus_A1159	21	18	3	0	scaffold_1	231057	281057
Aspergillus_fumigatus_A1159	23	0	23	0	scaffold_1	4371478	4421478
Aspergillus_fumigatus_A1159	20	16	4	0	scaffold_5	8444	58444
Aspergillus_fumigatus_A1159	16	15	1	0	scaffold_7	444967	494967
Aspergillus_fumigatus_A1159	18	16	2	0	scaffold_7	1045873	1095873
Aspergillus_fumigatus_A1159	21	21	0	0	scaffold_3	2071166	2121166
Aspergillus_fumigatus_A1159	22	18	4	0	scaffold_7	293203	343203
Aspergillus_fumigatus_A1159	24	22	2	0	scaffold_4	3566028	3616028
Aspergillus_fumigatus_A1159	22	18	4	0	scaffold_5	3201601	3251601
Aspergillus_fumigatus_A1159	20	18	2	0	scaffold_1	2261476	2311476
Aspergillus_fumigatus_A1159	19	17	2	0	scaffold_6	421218	471218
Aspergillus_fumigatus_A1159	15	12	3	0	scaffold_7	1540472	1590472
Aspergillus_fumigatus_A1159	21	18	3	0	scaffold_4	1757557	1807557
Aspergillus_fumigatus_A1159	20	19	1	0	scaffold_5	2242488	2292488
Aspergillus_fumigatus_A1159	15	13	2	0	scaffold_1	1921331	1971331
Aspergillus_fumigatus_A1159	19	18	1	0	scaffold_6	648139	698139
Aspergillus_fumigatus_A1159	20	19	1	0	scaffold_2	3549368	3599368
Aspergillus_fumigatus_A1159	19	18	1	0	scaffold_2	1948097	1998097
Aspergillus_fumigatus_A1159	26	22	4	0	scaffold_3	942524	992524
Aspergillus_fumigatus_A1159	15	14	1	0	scaffold_7	336050	386050
Aspergillus_fumigatus_A1159	26	20	6	0	scaffold_3	850684	900684
Aspergillus_fumigatus_A1159	20	18	2	0	scaffold_2	3380230	3430230
Aspergillus_fumigatus_A1159	21	21	0	0	scaffold_8	211897	261897
Aspergillus_fumigatus_A1159	15	12	3	0	scaffold_7	1544628	1594628
Aspergillus_fumigatus_A1159	26	23	3	0	scaffold_3	128425	178425
Aspergillus_fumigatus_A1159	19	19	0	0	scaffold_4	3170412	3220412
Aspergillus_fumigatus_A1159	17	17	0	0	scaffold_5	2130398	2180398
Aspergillus_fumigatus_A1159	14	12	2	0	scaffold_4	1026246	1076246
Aspergillus_fumigatus_A1159	20	19	1	0	scaffold_6	2396576	2446576
Aspergillus_fumigatus_A1159	23	23	0	0	scaffold_3	4274759	4324759
Aspergillus_fumigatus_A1159	20	19	1	0	scaffold_8	1128444	1178444
Aspergillus_fumigatus_A1159	17	17	0	0	scaffold_5	351665	401665
Aspergillus_fumigatus_A1159	19	19	0	0	scaffold_3	1582017	1632017
Aspergillus_fumigatus_A1159	23	21	2	0	scaffold_1	2051452	2101452
Aspergillus_fumigatus_A1159	18	15	3	0	scaffold_2	3318523	3368523
Aspergillus_fumigatus_A1159	4	3	1	0	scaffold_6	1053171	1103171
Aspergillus_fumigatus_A1159	20	17	3	0	scaffold_3	909864	959864
Aspergillus_fumigatus_A1159	16	15	1	0	scaffold_2	2750612	2800612
Aspergillus_fumigatus_A1159	21	21	0	0	scaffold_7	1148834	1198834
Aspergillus_fumigatus_A1159	21	20	1	0	scaffold_1	2567283	2617283
Aspergillus_fumigatus_A1159	18	15	3	0	scaffold_6	1999786	2049786
Aspergillus_fumigatus_A1159	19	19	0	0	scaffold_3	2717099	2767099
Aspergillus_fumigatus_A1159	25	24	1	0	scaffold_4	2166208	2216208
Aspergillus_fumigatus_A1159	20	17	3	0	scaffold_6	1874028	1924028
Aspergillus_fumigatus_A1159	25	22	3	0	scaffold_7	1793898	1843898
Aspergillus_fumigatus_A1159	24	19	5	0	scaffold_7	1379633	1429633
Aspergillus_fumigatus_A1159	20	19	1	0	scaffold_3	2645062	2695062
Aspergillus_fumigatus_A1159	17	14	3	0	scaffold_7	9454	59454
Aspergillus_fumigatus_A1159	18	14	4	0	scaffold_3	1747264	1797264
Aspergillus_fumigatus_A1159	23	21	2	0	scaffold_2	3369756	3419756
Aspergillus_fumigatus_A1159	21	19	2	0	scaffold_1	2760385	2810385
Aspergillus_fumigatus_A1159	17	15	2	0	scaffold_5	1687520	1737520
Aspergillus_fumigatus_A1159	17	17	0	0	scaffold_2	4289335	4339335
Aspergillus_fumigatus_A1159	21	14	7	0	scaffold_2	2566156	2616156
Aspergillus_fumigatus_A1159	17	15	2	0	scaffold_4	2016696	2066696
Aspergillus_fumigatus_A1159	15	11	4	0	scaffold_1	3671851	3721851
Aspergillus_fumigatus_A1159	26	22	4	0	scaffold_4	56347	106347
Aspergillus_fumigatus_A1159	24	24	0	0	scaffold_6	1630328	1680328
Aspergillus_fumigatus_A1159	26	22	4	0	scaffold_2	2685639	2735639
Aspergillus_fumigatus_A1159	18	15	3	0	scaffold_4	490719	540719
Aspergillus_fumigatus_A1159	21	18	3	0	scaffold_3	2320146	2370146
Aspergillus_fumigatus_A1159	23	21	2	0	scaffold_6	876545	926545
Aspergillus_fumigatus_A1159	18	17	1	0	scaffold_2	2836909	2886909
Aspergillus_fumigatus_A1159	21	18	3	0	scaffold_2	2715731	2765731
Aspergillus_fumigatus_A1159	23	21	2	0	scaffold_1	3523928	3573928
Aspergillus_fumigatus_A1159	15	12	3	0	scaffold_5	2008820	2058820
Aspergillus_fumigatus_A1159	20	19	1	0	scaffold_4	1139828	1189828
Aspergillus_fumigatus_A1159	19	16	3	0	scaffold_2	3340701	3390701
Aspergillus_fumigatus_A1159	20	19	1	0	scaffold_3	2041741	2091741
Aspergillus_fumigatus_A1159	22	21	1	0	scaffold_1	3188403	3238403
Aspergillus_fumigatus_A1159	16	15	1	0	scaffold_4	2205120	2255120
Aspergillus_fumigatus_A1159	16	15	1	0	scaffold_1	3577788	3627788
Aspergillus_fumigatus_A1159	18	15	3	0	scaffold_1	197700	247700
Aspergillus_fumigatus_A1159	17	14	3	0	scaffold_6	1798120	1848120
Aspergillus_fumigatus_A1159	23	20	3	0	scaffold_6	59074	109074
Aspergillus_fumigatus_A1159	18	14	4	0	scaffold_4	3698974	3748974
Aspergillus_fumigatus_A1159	16	15	1	0	scaffold_2	3735718	3785718
Aspergillus_fumigatus_A1159	19	19	0	0	scaffold_3	2052553	2102553
Aspergillus_fumigatus_A1159	23	20	3	0	scaffold_3	342362	392362
Aspergillus_fumigatus_A1159	16	9	7	0	scaffold_3	1880576	1930576
Aspergillus_fumigatus_A1159	19	11	8	0	scaffold_6	163097	213097
Aspergillus_fumigatus_A1159	22	21	1	0	scaffold_2	4418888	4468888
Aspergillus_fumigatus_A1159	17	17	0	0	scaffold_3	995587	1045587
Aspergillus_fumigatus_A1159	13	12	1	0	scaffold_2	392436	442436
Aspergillus_fumigatus_A1159	16	14	2	0	scaffold_2	1175172	1225172
Aspergillus_fumigatus_A1159	19	17	2	0	scaffold_3	1260467	1310467
Aspergillus_fumigatus_A1159	21	20	1	0	scaffold_4	3231215	3281215
Aspergillus_fumigatus_A1159	21	19	2	0	scaffold_1	298072	348072
Aspergillus_fumigatus_A1159	20	19	1	0	scaffold_3	2650732	2700732
Aspergillus_fumigatus_A1159	23	19	4	0	scaffold_7	268264	318264
Aspergillus_fumigatus_A1159	18	18	0	0	scaffold_1	2330290	2380290
Aspergillus_fumigatus_A1159	11	10	1	0	scaffold_3	4386501	4436501
Aspergillus_fumigatus_A1159	18	17	1	0	scaffold_6	1240469	1290469
Aspergillus_fumigatus_A1159	21	18	3	0	scaffold_2	2608003	2658003
Aspergillus_fumigatus_A1159	10	9	1	0	scaffold_1	1731499	1781499
Aspergillus_fumigatus_A1159	22	21	1	0	scaffold_4	857002	907002
Aspergillus_fumigatus_A1159	17	16	1	0	scaffold_7	1253434	1303434
Aspergillus_fumigatus_A1159	16	16	0	0	scaffold_2	2816223	2866223
Aspergillus_fumigatus_A1159	22	17	5	0	scaffold_3	864790	914790
Aspergillus_fumigatus_A1159	18	17	1	0	scaffold_2	1812892	1862892
Aspergillus_fumigatus_A1159	18	16	2	0	scaffold_2	2615484	2665484
Aspergillus_fumigatus_A1159	23	22	1	0	scaffold_2	183094	233094
Aspergillus_fumigatus_A1159	20	15	5	0	scaffold_1	1321378	1371378
Aspergillus_fumigatus_A1159	25	21	4	0	scaffold_5	429659	479659
Aspergillus_fumigatus_A1159	20	17	3	0	scaffold_6	413502	463502
Aspergillus_fumigatus_A1159	19	11	8	0	scaffold_1	4469101	4519101
Aspergillus_fumigatus_A1159	22	19	3	0	scaffold_2	2698910	2748910
Aspergillus_fumigatus_A1159	15	12	3	0	scaffold_5	2008238	2058238
Aspergillus_fumigatus_A1159	25	19	6	0	scaffold_4	24367	74367
Aspergillus_fumigatus_A1159	18	14	4	0	scaffold_1	4152703	4202703
Aspergillus_fumigatus_A1159	18	17	1	0	scaffold_8	120551	170551
Aspergillus_fumigatus_A1159	16	14	2	0	scaffold_4	3102515	3152515
Aspergillus_fumigatus_A1159	21	18	3	0	scaffold_3	1346071	1396071
Aspergillus_fumigatus_A1159	8	7	1	0	scaffold_6	1059501	1109501
Aspergillus_fumigatus_A1159	22	21	1	0	scaffold_2	2002964	2052964
Aspergillus_fumigatus_A1159	17	0	17	0	scaffold_1	4327610	4377610
Aspergillus_fumigatus_A1159	20	13	7	0	scaffold_6	2071234	2121234
Aspergillus_fumigatus_A1159	16	13	3	0	scaffold_7	97278	147278
Aspergillus_fumigatus_A1159	24	21	3	0	scaffold_3	2237560	2287560
Aspergillus_fumigatus_A1159	25	17	8	0	scaffold_1	74228	124228
Aspergillus_fumigatus_A1159	16	16	0	0	scaffold_3	2998468	3048468
Aspergillus_fumigatus_A1159	24	22	2	0	scaffold_3	192882	242882
Aspergillus_fumigatus_A1159	22	20	2	0	scaffold_2	927796	977796
Aspergillus_fumigatus_A1159	22	20	2	0	scaffold_7	162953	212953
Aspergillus_fumigatus_A1159	17	17	0	0	scaffold_2	3851938	3901938
Aspergillus_fumigatus_A1159	20	15	5	0	scaffold_5	3871	53871
Aspergillus_fumigatus_A1159	17	17	0	0	scaffold_2	3525974	3575974
Aspergillus_fumigatus_A1159	21	17	4	0	scaffold_5	3613382	3663382
Aspergillus_fumigatus_A1159	20	18	2	0	scaffold_1	344079	394079
Aspergillus_fumigatus_A1159	24	22	2	0	scaffold_4	2674602	2724602
Aspergillus_fumigatus_A1159	23	21	2	0	scaffold_2	3014059	3064059
Aspergillus_fumigatus_A1159	21	18	3	0	scaffold_6	2107206	2157206
Aspergillus_fumigatus_A1159	20	20	0	0	scaffold_6	1387718	1437718
Aspergillus_fumigatus_A1159	16	15	1	0	scaffold_5	3246239	3296239
Aspergillus_fumigatus_A1159	16	8	8	0	scaffold_2	3244	53244
Aspergillus_fumigatus_A1159	19	19	0	0	scaffold_1	2329351	2379351
Aspergillus_fumigatus_A1159	16	16	0	0	scaffold_4	3377109	3427109
Aspergillus_fumigatus_A1159	23	19	4	0	scaffold_1	4630444	4680444
Aspergillus_fumigatus_A1159	21	21	0	0	scaffold_2	1545353	1595353
Aspergillus_fumigatus_A1159	23	21	2	0	scaffold_1	2448706	2498706
Aspergillus_fumigatus_A1159	18	15	3	0	scaffold_1	1141800	1191800
Aspergillus_fumigatus_A1159	17	13	4	0	scaffold_3	2362012	2412012
Aspergillus_fumigatus_A1159	17	17	0	0	scaffold_6	1383238	1433238
Aspergillus_fumigatus_A1159	22	19	3	0	scaffold_8	877072	927072
Aspergillus_fumigatus_A1159	18	16	2	0	scaffold_2	4377338	4427338
Aspergillus_fumigatus_A1159	23	21	2	0	scaffold_2	3364078	3414078
Aspergillus_fumigatus_A1159	17	15	2	0	scaffold_2	2253371	2303371
Aspergillus_fumigatus_A1159	18	13	5	0	scaffold_2	601911	651911
Aspergillus_fumigatus_A1159	22	20	2	0	scaffold_3	188843	238843
Aspergillus_fumigatus_A1159	13	13	0	0	scaffold_1	1636932	1686932
Aspergillus_fumigatus_A1159	25	23	2	0	scaffold_8	1186052	1236052
Aspergillus_fumigatus_A1159	21	13	8	0	scaffold_6	2061515	2111515
Aspergillus_fumigatus_A1159	13	12	1	0	scaffold_3	3279208	3329208
Aspergillus_fumigatus_A1159	14	12	2	0	scaffold_1	877142	927142
Aspergillus_fumigatus_A1159	15	14	1	0	scaffold_5	1256918	1306918
Aspergillus_fumigatus_A1159	19	15	4	0	scaffold_1	269545	319545
Aspergillus_fumigatus_A1159	15	14	1	0	scaffold_6	2559322	2609322
Aspergillus_fumigatus_A1159	19	17	2	0	scaffold_3	3627691	3677691
Aspergillus_fumigatus_A1159	22	0	22	0	scaffold_1	4390689	4440689
Aspergillus_fumigatus_A1159	18	14	4	0	scaffold_1	3426679	3476679
Aspergillus_fumigatus_A1159	18	16	2	0	scaffold_3	1274338	1324338
Aspergillus_fumigatus_A1159	20	20	0	0	scaffold_6	1723451	1773451
Aspergillus_fumigatus_A1159	26	23	3	0	scaffold_3	428580	478580
Aspergillus_fumigatus_A1159	18	16	2	0	scaffold_6	1119522	1169522
Aspergillus_fumigatus_A1159	24	19	5	0	scaffold_5	3608887	3658887
Aspergillus_fumigatus_A1159	23	21	2	0	scaffold_3	1484011	1534011
Aspergillus_fumigatus_A1159	20	17	3	0	scaffold_3	1721402	1771402
Aspergillus_fumigatus_A1159	24	22	2	0	scaffold_5	449071	499071
Aspergillus_fumigatus_A1159	10	10	0	0	scaffold_1	2001625	2051625
Aspergillus_fumigatus_A1159	18	18	0	0	scaffold_5	1941631	1991631
Aspergillus_fumigatus_A1159	18	18	0	0	scaffold_5	3229382	3279382
Aspergillus_fumigatus_A1159	17	15	2	0	scaffold_2	408736	458736
Aspergillus_fumigatus_A1159	15	13	2	0	scaffold_2	1059528	1109528
Aspergillus_fumigatus_A1159	0	0	0	0	scaffold_4	2251841	2301841
Aspergillus_fumigatus_A1159	16	16	0	0	scaffold_1	585916	635916
Aspergillus_fumigatus_A1159	18	18	0	0	scaffold_5	2854720	2904720
Aspergillus_fumigatus_A1159	20	18	2	0	scaffold_6	1895909	1945909
Aspergillus_fumigatus_A1159	16	13	3	0	scaffold_3	2388197	2438197
Aspergillus_fumigatus_A1159	20	18	2	0	scaffold_6	2190733	2240733
Aspergillus_fumigatus_A1159	21	20	1	0	scaffold_2	196884	246884
Aspergillus_fumigatus_A1159	15	13	2	0	scaffold_2	3488351	3538351
Aspergillus_fumigatus_A1159	21	20	1	0	scaffold_2	3677344	3727344
Aspergillus_fumigatus_A1159	19	19	0	0	scaffold_5	2476071	2526071
Aspergillus_fumigatus_A1159	17	17	0	0	scaffold_5	2542367	2592367
Aspergillus_fumigatus_A1159	17	16	1	0	scaffold_4	2764059	2814059
Aspergillus_fumigatus_A1159	16	14	2	0	scaffold_4	2730615	2780615
Aspergillus_fumigatus_A1159	16	15	1	0	scaffold_5	1298681	1348681
Aspergillus_fumigatus_A1159	21	18	3	0	scaffold_8	870715	920715
Aspergillus_fumigatus_A1159	21	17	4	0	scaffold_5	3200510	3250510
Aspergillus_fumigatus_A1159	18	18	0	0	scaffold_6	1923875	1973875
Aspergillus_fumigatus_A1159	18	15	3	0	scaffold_5	1530310	1580310
Aspergillus_fumigatus_A1159	12	9	3	0	scaffold_2	2515163	2565163
Aspergillus_fumigatus_A1159	20	19	1	0	scaffold_6	2954792	3004792
Aspergillus_fumigatus_A1159	19	18	1	0	scaffold_2	216090	266090
Aspergillus_fumigatus_A1159	18	16	2	0	scaffold_2	2867533	2917533
Aspergillus_fumigatus_A1159	11	6	5	0	scaffold_4	2326982	2376982
Aspergillus_fumigatus_A1159	19	17	2	0	scaffold_6	3307180	3357180
Aspergillus_fumigatus_A1159	21	19	2	0	scaffold_4	92724	142724
Aspergillus_fumigatus_A1159	20	17	3	0	scaffold_3	661756	711756
Aspergillus_fumigatus_A1159	25	21	4	0	scaffold_4	2876792	2926792
Aspergillus_fumigatus_A1159	13	11	2	0	scaffold_8	778115	828115
Aspergillus_fumigatus_A1159	17	16	1	0	scaffold_2	2388963	2438963
Aspergillus_fumigatus_A1159	14	11	3	0	scaffold_2	1072984	1122984
Aspergillus_fumigatus_A1159	24	18	6	0	scaffold_1	111290	161290
Aspergillus_fumigatus_A1159	22	21	1	0	scaffold_6	2119746	2169746
Aspergillus_fumigatus_A1159	14	13	1	0	scaffold_2	3121892	3171892
Aspergillus_fumigatus_A1159	20	17	3	0	scaffold_2	1910350	1960350
Aspergillus_fumigatus_A1159	21	21	0	0	scaffold_1	2098712	2148712
Aspergillus_fumigatus_A1159	18	18	0	0	scaffold_2	4318558	4368558
Aspergillus_fumigatus_A1159	22	19	3	0	scaffold_7	1057664	1107664
Aspergillus_fumigatus_A1159	17	17	0	0	scaffold_3	3335624	3385624
Aspergillus_fumigatus_A1159	17	16	1	0	scaffold_2	3504477	3554477
Aspergillus_fumigatus_A1159	24	18	6	0	scaffold_5	167938	217938
Aspergillus_fumigatus_A1159	20	17	3	0	scaffold_3	923282	973282
Aspergillus_fumigatus_A1159	17	17	0	0	scaffold_3	2871082	2921082
Aspergillus_fumigatus_A1159	19	17	2	0	scaffold_8	328958	378958
Aspergillus_fumigatus_A1159	19	18	1	0	scaffold_4	1665793	1715793
Aspergillus_fumigatus_A1159	21	18	3	0	scaffold_1	2237232	2287232
Aspergillus_fumigatus_A1159	17	15	2	0	scaffold_3	2529780	2579780
Aspergillus_fumigatus_A1159	20	17	3	0	scaffold_8	162395	212395
Aspergillus_fumigatus_A1159	26	23	3	0	scaffold_2	2681157	2731157
Aspergillus_fumigatus_A1159	17	17	0	0	scaffold_1	508279	558279
Aspergillus_fumigatus_A1159	19	19	0	0	scaffold_6	900017	950017
Aspergillus_fumigatus_A1159	16	14	2	0	scaffold_2	3757302	3807302
Aspergillus_fumigatus_A1159	22	21	1	0	scaffold_1	3935609	3985609
Aspergillus_fumigatus_A1159	20	18	2	0	scaffold_7	418663	468663
Aspergillus_fumigatus_A1159	22	22	0	0	scaffold_7	1601046	1651046
Aspergillus_fumigatus_A1159	23	20	3	0	scaffold_4	1851812	1901812
Aspergillus_fumigatus_A1159	21	20	1	0	scaffold_2	3677543	3727543
Aspergillus_fumigatus_A1159	20	17	3	0	scaffold_7	1494229	1544229
Aspergillus_fumigatus_A1159	17	16	1	0	scaffold_3	1567321	1617321
Aspergillus_fumigatus_A1159	17	16	1	0	scaffold_3	3506870	3556870
Aspergillus_fumigatus_A1159	7	6	1	0	scaffold_4	154397	204397
Aspergillus_fumigatus_A1159	18	16	2	0	scaffold_4	1189660	1239660
Aspergillus_fumigatus_A1159	22	19	3	0	scaffold_3	1150075	1200075
Aspergillus_fumigatus_A1159	17	17	0	0	scaffold_1	575519	625519
Aspergillus_fumigatus_A1159	21	20	1	0	scaffold_6	2129617	2179617
Aspergillus_fumigatus_A1159	22	20	2	0	scaffold_1	13133	63133
Aspergillus_fumigatus_A1159	20	19	1	0	scaffold_6	2398134	2448134
Aspergillus_fumigatus_A1159	18	15	3	0	scaffold_7	1533450	1583450
Aspergillus_fumigatus_A1159	24	21	3	0	scaffold_5	2334926	2384926
Aspergillus_fumigatus_A1159	17	14	3	0	scaffold_6	504659	554659
Aspergillus_fumigatus_A1159	21	20	1	0	scaffold_4	2828197	2878197
Aspergillus_fumigatus_A1159	18	15	3	0	scaffold_5	1089010	1139010
Aspergillus_fumigatus_A1159	15	13	2	0	scaffold_6	2201647	2251647
Aspergillus_fumigatus_A1159	16	9	7	0	scaffold_4	2336718	2386718
Aspergillus_fumigatus_A1159	15	13	2	0	scaffold_4	1348740	1398740
Aspergillus_fumigatus_A1159	23	22	1	0	scaffold_2	2000023	2050023
Aspergillus_fumigatus_A1159	21	20	1	0	scaffold_4	3225138	3275138
Aspergillus_fumigatus_A1159	16	14	2	0	scaffold_3	616379	666379
Aspergillus_fumigatus_A1159	23	21	2	0	scaffold_8	61617	111617
Aspergillus_fumigatus_A1159	15	13	2	0	scaffold_8	604866	654866
Aspergillus_fumigatus_A1159	18	17	1	0	scaffold_3	3449305	3499305
Aspergillus_fumigatus_A1159	11	10	1	0	scaffold_1	3588601	3638601
Aspergillus_fumigatus_A1159	13	11	2	0	scaffold_3	2544755	2594755
Aspergillus_fumigatus_A1159	20	19	1	0	scaffold_2	1653379	1703379
Aspergillus_fumigatus_A1159	21	18	3	0	scaffold_2	4499669	4549669
Aspergillus_fumigatus_A1159	21	19	2	0	scaffold_1	2466132	2516132
Aspergillus_fumigatus_A1159	23	22	1	0	scaffold_8	1181417	1231417
Aspergillus_fumigatus_A1159	18	18	0	0	scaffold_2	4439891	4489891
Aspergillus_fumigatus_A1159	22	20	2	0	scaffold_4	96740	146740
Aspergillus_fumigatus_A1159	25	21	4	0	scaffold_6	1527020	1577020
Aspergillus_fumigatus_A1159	16	15	1	0	scaffold_1	3706132	3756132
Aspergillus_fumigatus_A1159	18	17	1	0	scaffold_2	2368924	2418924
Aspergillus_fumigatus_A1159	19	18	1	0	scaffold_4	1244905	1294905
Aspergillus_fumigatus_A1159	19	17	2	0	scaffold_5	2195714	2245714
Aspergillus_fumigatus_A1159	13	11	2	0	scaffold_2	4100328	4150328
Aspergillus_fumigatus_A1159	15	15	0	0	scaffold_3	3136065	3186065
Aspergillus_fumigatus_A1159	18	13	5	0	scaffold_1	2196305	2246305
Aspergillus_fumigatus_A1159	19	19	0	0	scaffold_4	3679652	3729652
Aspergillus_fumigatus_A1159	20	19	1	0	scaffold_6	1368107	1418107
Aspergillus_fumigatus_A1159	20	15	5	0	scaffold_1	1349593	1399593
Aspergillus_fumigatus_A1159	18	17	1	0	scaffold_1	3836696	3886696
Aspergillus_fumigatus_A1159	18	18	0	0	scaffold_4	3383969	3433969
