STRAIN	TOTAL	CORE	ACCESSORY	SINGLETON	CHROM	START	END
Aspergillus_fumigatus_AF100-11A	21	20	1	0	scaffold_4	3175852	3225852
Aspergillus_fumigatus_AF100-11A	18	16	2	0	scaffold_4	2370237	2420237
Aspergillus_fumigatus_AF100-11A	18	17	1	0	scaffold_2	4585233	4635233
Aspergillus_fumigatus_AF100-11A	15	15	0	0	scaffold_2	834944	884944
Aspergillus_fumigatus_AF100-11A	23	20	3	0	scaffold_2	2123984	2173984
Aspergillus_fumigatus_AF100-11A	21	21	0	0	scaffold_6	2348251	2398251
Aspergillus_fumigatus_AF100-11A	21	18	3	0	scaffold_2	2105128	2155128
Aspergillus_fumigatus_AF100-11A	16	15	1	0	scaffold_7	1283673	1333673
Aspergillus_fumigatus_AF100-11A	21	17	4	0	scaffold_4	80180	130180
Aspergillus_fumigatus_AF100-11A	15	13	2	0	scaffold_8	657934	707934
Aspergillus_fumigatus_AF100-11A	4	3	1	0	scaffold_8	775727	825727
Aspergillus_fumigatus_AF100-11A	16	16	0	0	scaffold_1	1394723	1444723
Aspergillus_fumigatus_AF100-11A	17	16	1	0	scaffold_6	1278929	1328929
Aspergillus_fumigatus_AF100-11A	16	16	0	0	scaffold_4	3226039	3276039
Aspergillus_fumigatus_AF100-11A	16	14	2	0	scaffold_1	2973679	3023679
Aspergillus_fumigatus_AF100-11A	21	20	1	0	scaffold_1	2525741	2575741
Aspergillus_fumigatus_AF100-11A	17	17	0	0	scaffold_1	715770	765770
Aspergillus_fumigatus_AF100-11A	4	4	0	0	scaffold_1	1913760	1963760
Aspergillus_fumigatus_AF100-11A	17	14	3	0	scaffold_3	25918	75918
Aspergillus_fumigatus_AF100-11A	17	17	0	0	scaffold_1	2672639	2722639
Aspergillus_fumigatus_AF100-11A	21	19	2	0	scaffold_2	2358698	2408698
Aspergillus_fumigatus_AF100-11A	11	11	0	0	scaffold_1	1809749	1859749
Aspergillus_fumigatus_AF100-11A	20	15	5	0	scaffold_6	649111	699111
Aspergillus_fumigatus_AF100-11A	19	19	0	0	scaffold_7	894081	944081
Aspergillus_fumigatus_AF100-11A	9	7	2	0	scaffold_5	1289848	1339848
Aspergillus_fumigatus_AF100-11A	19	16	3	0	scaffold_7	481032	531032
Aspergillus_fumigatus_AF100-11A	21	18	3	0	scaffold_4	2845647	2895647
Aspergillus_fumigatus_AF100-11A	18	15	3	0	scaffold_3	3688013	3738013
Aspergillus_fumigatus_AF100-11A	22	20	2	0	scaffold_2	2889011	2939011
Aspergillus_fumigatus_AF100-11A	18	18	0	0	scaffold_2	3983249	4033249
Aspergillus_fumigatus_AF100-11A	21	19	2	0	scaffold_3	2297728	2347728
Aspergillus_fumigatus_AF100-11A	14	13	1	0	scaffold_2	1185906	1235906
Aspergillus_fumigatus_AF100-11A	23	21	2	0	scaffold_6	2591245	2641245
Aspergillus_fumigatus_AF100-11A	22	20	2	0	scaffold_1	3854035	3904035
Aspergillus_fumigatus_AF100-11A	19	18	1	0	scaffold_3	2558425	2608425
Aspergillus_fumigatus_AF100-11A	1	1	0	0	scaffold_6	1248004	1298004
Aspergillus_fumigatus_AF100-11A	5	4	1	0	scaffold_5	2260581	2310581
Aspergillus_fumigatus_AF100-11A	20	17	3	0	scaffold_2	3180755	3230755
Aspergillus_fumigatus_AF100-11A	18	15	3	0	scaffold_4	3535605	3585605
Aspergillus_fumigatus_AF100-11A	21	17	4	0	scaffold_3	2361534	2411534
Aspergillus_fumigatus_AF100-11A	18	18	0	0	scaffold_3	3756119	3806119
Aspergillus_fumigatus_AF100-11A	17	14	3	0	scaffold_6	2461427	2511427
Aspergillus_fumigatus_AF100-11A	19	17	2	0	scaffold_6	402446	452446
Aspergillus_fumigatus_AF100-11A	20	19	1	0	scaffold_3	1897884	1947884
Aspergillus_fumigatus_AF100-11A	10	2	8	0	scaffold_2	75473	125473
Aspergillus_fumigatus_AF100-11A	15	15	0	0	scaffold_2	836942	886942
Aspergillus_fumigatus_AF100-11A	23	19	4	0	scaffold_1	391663	441663
Aspergillus_fumigatus_AF100-11A	18	17	1	0	scaffold_4	1558432	1608432
Aspergillus_fumigatus_AF100-11A	18	18	0	0	scaffold_2	582588	632588
Aspergillus_fumigatus_AF100-11A	14	1	13	0	scaffold_6	13635	63635
Aspergillus_fumigatus_AF100-11A	18	17	1	0	scaffold_4	2040632	2090632
Aspergillus_fumigatus_AF100-11A	16	16	0	0	scaffold_2	4007160	4057160
Aspergillus_fumigatus_AF100-11A	18	17	1	0	scaffold_2	3233071	3283071
Aspergillus_fumigatus_AF100-11A	13	11	2	0	scaffold_3	994245	1044245
Aspergillus_fumigatus_AF100-11A	20	20	0	0	scaffold_2	406599	456599
Aspergillus_fumigatus_AF100-11A	1	1	0	0	scaffold_5	1260990	1310990
Aspergillus_fumigatus_AF100-11A	7	6	1	0	scaffold_6	1263705	1313705
Aspergillus_fumigatus_AF100-11A	19	19	0	0	scaffold_1	2758177	2808177
Aspergillus_fumigatus_AF100-11A	19	18	1	0	scaffold_1	2211937	2261937
Aspergillus_fumigatus_AF100-11A	20	19	1	0	scaffold_2	2274929	2324929
Aspergillus_fumigatus_AF100-11A	20	18	2	0	scaffold_1	2318310	2368310
Aspergillus_fumigatus_AF100-11A	23	20	3	0	scaffold_4	498648	548648
Aspergillus_fumigatus_AF100-11A	17	15	2	0	scaffold_6	982942	1032942
Aspergillus_fumigatus_AF100-11A	22	19	3	0	scaffold_7	203796	253796
Aspergillus_fumigatus_AF100-11A	18	17	1	0	scaffold_3	191508	241508
Aspergillus_fumigatus_AF100-11A	22	21	1	0	scaffold_3	3001081	3051081
Aspergillus_fumigatus_AF100-11A	19	18	1	0	scaffold_6	1989814	2039814
Aspergillus_fumigatus_AF100-11A	19	18	1	0	scaffold_4	2014230	2064230
Aspergillus_fumigatus_AF100-11A	13	11	2	0	scaffold_2	2073290	2123290
Aspergillus_fumigatus_AF100-11A	18	15	3	0	scaffold_2	1428270	1478270
Aspergillus_fumigatus_AF100-11A	20	17	3	0	scaffold_8	451199	501199
Aspergillus_fumigatus_AF100-11A	25	24	1	0	scaffold_5	1561115	1611115
Aspergillus_fumigatus_AF100-11A	18	17	1	0	scaffold_3	3077507	3127507
Aspergillus_fumigatus_AF100-11A	18	15	3	0	scaffold_2	1428190	1478190
Aspergillus_fumigatus_AF100-11A	18	17	1	0	scaffold_3	3298932	3348932
Aspergillus_fumigatus_AF100-11A	19	19	0	0	scaffold_8	130620	180620
Aspergillus_fumigatus_AF100-11A	15	10	5	0	scaffold_5	2865831	2915831
Aspergillus_fumigatus_AF100-11A	17	15	2	0	scaffold_3	709991	759991
Aspergillus_fumigatus_AF100-11A	21	19	2	0	scaffold_3	1760324	1810324
Aspergillus_fumigatus_AF100-11A	22	21	1	0	scaffold_3	3495762	3545762
Aspergillus_fumigatus_AF100-11A	17	11	6	0	scaffold_2	239911	289911
Aspergillus_fumigatus_AF100-11A	18	16	2	0	scaffold_2	3425078	3475078
Aspergillus_fumigatus_AF100-11A	13	12	1	0	scaffold_1	1124811	1174811
Aspergillus_fumigatus_AF100-11A	18	18	0	0	scaffold_8	1240501	1290501
Aspergillus_fumigatus_AF100-11A	21	19	2	0	scaffold_1	3056284	3106284
Aspergillus_fumigatus_AF100-11A	21	20	1	0	scaffold_4	563809	613809
Aspergillus_fumigatus_AF100-11A	6	6	0	0	scaffold_2	3485961	3535961
Aspergillus_fumigatus_AF100-11A	18	15	3	0	scaffold_6	2615889	2665889
Aspergillus_fumigatus_AF100-11A	0	0	0	0	scaffold_6	1240228	1290228
Aspergillus_fumigatus_AF100-11A	23	19	4	0	scaffold_4	484484	534484
Aspergillus_fumigatus_AF100-11A	20	17	3	0	scaffold_5	1903435	1953435
Aspergillus_fumigatus_AF100-11A	19	19	0	0	scaffold_4	3121810	3171810
Aspergillus_fumigatus_AF100-11A	17	15	2	0	scaffold_2	1867983	1917983
Aspergillus_fumigatus_AF100-11A	23	23	0	0	scaffold_2	4328527	4378527
Aspergillus_fumigatus_AF100-11A	20	14	6	0	scaffold_1	187697	237697
Aspergillus_fumigatus_AF100-11A	21	19	2	0	scaffold_1	3852244	3902244
Aspergillus_fumigatus_AF100-11A	19	19	0	0	scaffold_5	1067547	1117547
Aspergillus_fumigatus_AF100-11A	17	14	3	0	scaffold_4	3456901	3506901
Aspergillus_fumigatus_AF100-11A	15	14	1	0	scaffold_3	1305953	1355953
Aspergillus_fumigatus_AF100-11A	17	10	7	0	scaffold_1	4561344	4611344
Aspergillus_fumigatus_AF100-11A	18	17	1	0	scaffold_4	414531	464531
Aspergillus_fumigatus_AF100-11A	21	20	1	0	scaffold_7	95359	145359
Aspergillus_fumigatus_AF100-11A	23	22	1	0	scaffold_2	3042204	3092204
Aspergillus_fumigatus_AF100-11A	19	19	0	0	scaffold_4	3387512	3437512
Aspergillus_fumigatus_AF100-11A	19	19	0	0	scaffold_8	1230198	1280198
Aspergillus_fumigatus_AF100-11A	22	20	2	0	scaffold_1	2895770	2945770
Aspergillus_fumigatus_AF100-11A	0	0	0	0	scaffold_5	2198563	2248563
Aspergillus_fumigatus_AF100-11A	14	13	1	0	scaffold_8	1297444	1347444
Aspergillus_fumigatus_AF100-11A	23	22	1	0	scaffold_2	2267086	2317086
Aspergillus_fumigatus_AF100-11A	18	17	1	0	scaffold_4	813817	863817
Aspergillus_fumigatus_AF100-11A	13	12	1	0	scaffold_5	1857190	1907190
Aspergillus_fumigatus_AF100-11A	16	15	1	0	scaffold_1	1371940	1421940
Aspergillus_fumigatus_AF100-11A	22	21	1	0	scaffold_7	941108	991108
Aspergillus_fumigatus_AF100-11A	19	17	2	0	scaffold_3	3056643	3106643
Aspergillus_fumigatus_AF100-11A	16	14	2	0	scaffold_2	3428689	3478689
Aspergillus_fumigatus_AF100-11A	18	16	2	0	scaffold_3	3413042	3463042
Aspergillus_fumigatus_AF100-11A	18	14	4	0	scaffold_5	3089811	3139811
Aspergillus_fumigatus_AF100-11A	16	16	0	0	scaffold_6	2892260	2942260
Aspergillus_fumigatus_AF100-11A	18	18	0	0	scaffold_3	1669018	1719018
Aspergillus_fumigatus_AF100-11A	19	18	1	0	scaffold_2	1084720	1134720
Aspergillus_fumigatus_AF100-11A	18	18	0	0	scaffold_2	1143254	1193254
Aspergillus_fumigatus_AF100-11A	19	19	0	0	scaffold_1	2678605	2728605
Aspergillus_fumigatus_AF100-11A	20	18	2	0	scaffold_3	2624680	2674680
Aspergillus_fumigatus_AF100-11A	13	9	4	0	scaffold_5	3711103	3761103
Aspergillus_fumigatus_AF100-11A	17	15	2	0	scaffold_1	2979095	3029095
Aspergillus_fumigatus_AF100-11A	25	22	3	0	scaffold_7	1598869	1648869
Aspergillus_fumigatus_AF100-11A	18	15	3	0	scaffold_8	282445	332445
Aspergillus_fumigatus_AF100-11A	16	13	3	0	scaffold_3	978060	1028060
Aspergillus_fumigatus_AF100-11A	21	18	3	0	scaffold_3	100801	150801
Aspergillus_fumigatus_AF100-11A	6	5	1	0	scaffold_2	3451256	3501256
Aspergillus_fumigatus_AF100-11A	18	16	2	0	scaffold_2	1541010	1591010
Aspergillus_fumigatus_AF100-11A	14	12	2	0	scaffold_2	3434188	3484188
Aspergillus_fumigatus_AF100-11A	14	10	4	0	scaffold_7	123105	173105
Aspergillus_fumigatus_AF100-11A	20	17	3	0	scaffold_2	3097014	3147014
Aspergillus_fumigatus_AF100-11A	22	18	4	0	scaffold_8	431742	481742
Aspergillus_fumigatus_AF100-11A	22	16	6	0	scaffold_4	1637787	1687787
Aspergillus_fumigatus_AF100-11A	12	11	1	0	scaffold_1	1855672	1905672
Aspergillus_fumigatus_AF100-11A	20	20	0	0	scaffold_2	1697474	1747474
Aspergillus_fumigatus_AF100-11A	20	16	4	0	scaffold_2	2093156	2143156
Aspergillus_fumigatus_AF100-11A	21	12	9	0	scaffold_6	2249479	2299479
Aspergillus_fumigatus_AF100-11A	27	22	5	0	scaffold_6	550378	600378
Aspergillus_fumigatus_AF100-11A	19	18	1	0	scaffold_2	617630	667630
Aspergillus_fumigatus_AF100-11A	24	21	3	0	scaffold_8	1466261	1516261
Aspergillus_fumigatus_AF100-11A	19	19	0	0	scaffold_8	1236027	1286027
Aspergillus_fumigatus_AF100-11A	7	7	0	0	scaffold_1	1924098	1974098
Aspergillus_fumigatus_AF100-11A	16	8	8	0	scaffold_3	677915	727915
Aspergillus_fumigatus_AF100-11A	18	16	2	0	scaffold_7	1311613	1361613
Aspergillus_fumigatus_AF100-11A	16	15	1	0	scaffold_6	1333252	1383252
Aspergillus_fumigatus_AF100-11A	21	21	0	0	scaffold_5	642088	692088
Aspergillus_fumigatus_AF100-11A	22	20	2	0	scaffold_3	2187895	2237895
Aspergillus_fumigatus_AF100-11A	17	15	2	0	scaffold_1	3039599	3089599
Aspergillus_fumigatus_AF100-11A	16	12	4	0	scaffold_1	3456086	3506086
Aspergillus_fumigatus_AF100-11A	20	15	5	0	scaffold_5	2947063	2997063
Aspergillus_fumigatus_AF100-11A	17	16	1	0	scaffold_1	1712934	1762934
Aspergillus_fumigatus_AF100-11A	19	18	1	0	scaffold_1	2488438	2538438
Aspergillus_fumigatus_AF100-11A	17	15	2	0	scaffold_8	1127135	1177135
Aspergillus_fumigatus_AF100-11A	18	15	3	0	scaffold_2	4671771	4721771
Aspergillus_fumigatus_AF100-11A	18	17	1	0	scaffold_5	3676756	3726756
Aspergillus_fumigatus_AF100-11A	19	19	0	0	scaffold_6	1580338	1630338
Aspergillus_fumigatus_AF100-11A	17	17	0	0	scaffold_1	2697774	2747774
Aspergillus_fumigatus_AF100-11A	21	20	1	0	scaffold_5	1395194	1445194
Aspergillus_fumigatus_AF100-11A	18	18	0	0	scaffold_6	1086646	1136646
Aspergillus_fumigatus_AF100-11A	23	23	0	0	scaffold_6	1922879	1972879
Aspergillus_fumigatus_AF100-11A	19	17	2	0	scaffold_2	1256827	1306827
Aspergillus_fumigatus_AF100-11A	25	21	3	1	scaffold_2	4299537	4349537
Aspergillus_fumigatus_AF100-11A	11	7	4	0	scaffold_1	2094398	2144398
Aspergillus_fumigatus_AF100-11A	18	13	5	0	scaffold_5	224376	274376
Aspergillus_fumigatus_AF100-11A	17	14	3	0	scaffold_3	1946560	1996560
Aspergillus_fumigatus_AF100-11A	28	22	6	0	scaffold_5	45351	95351
Aspergillus_fumigatus_AF100-11A	21	18	3	0	scaffold_6	2299420	2349420
Aspergillus_fumigatus_AF100-11A	10	8	2	0	scaffold_4	2454623	2504623
Aspergillus_fumigatus_AF100-11A	22	20	2	0	scaffold_8	1050757	1100757
Aspergillus_fumigatus_AF100-11A	19	16	3	0	scaffold_3	1021275	1071275
Aspergillus_fumigatus_AF100-11A	19	18	1	0	scaffold_1	3325505	3375505
Aspergillus_fumigatus_AF100-11A	24	21	3	0	scaffold_3	373214	423214
Aspergillus_fumigatus_AF100-11A	16	16	0	0	scaffold_6	2134066	2184066
Aspergillus_fumigatus_AF100-11A	16	15	1	0	scaffold_1	1329030	1379030
Aspergillus_fumigatus_AF100-11A	17	15	2	0	scaffold_7	25068	75068
Aspergillus_fumigatus_AF100-11A	27	21	6	0	scaffold_4	186216	236216
Aspergillus_fumigatus_AF100-11A	10	7	3	0	scaffold_8	541358	591358
Aspergillus_fumigatus_AF100-11A	20	19	1	0	scaffold_3	909838	959838
Aspergillus_fumigatus_AF100-11A	19	15	4	0	scaffold_3	1855782	1905782
Aspergillus_fumigatus_AF100-11A	15	15	0	0	scaffold_2	3516416	3566416
Aspergillus_fumigatus_AF100-11A	18	15	2	1	scaffold_3	3368572	3418572
Aspergillus_fumigatus_AF100-11A	23	20	3	0	scaffold_3	2193607	2243607
Aspergillus_fumigatus_AF100-11A	16	16	0	0	scaffold_1	599515	649515
Aspergillus_fumigatus_AF100-11A	17	14	3	0	scaffold_1	1489341	1539341
Aspergillus_fumigatus_AF100-11A	17	14	3	0	scaffold_8	839165	889165
Aspergillus_fumigatus_AF100-11A	17	16	1	0	scaffold_2	3158474	3208474
Aspergillus_fumigatus_AF100-11A	18	12	6	0	scaffold_2	235524	285524
Aspergillus_fumigatus_AF100-11A	18	16	2	0	scaffold_6	3322037	3372037
Aspergillus_fumigatus_AF100-11A	1	1	0	0	scaffold_7	743211	793211
Aspergillus_fumigatus_AF100-11A	20	17	3	0	scaffold_5	3502915	3552915
Aspergillus_fumigatus_AF100-11A	21	15	6	0	scaffold_2	229590	279590
Aspergillus_fumigatus_AF100-11A	16	14	2	0	scaffold_4	830374	880374
Aspergillus_fumigatus_AF100-11A	17	15	2	0	scaffold_4	1389897	1439897
Aspergillus_fumigatus_AF100-11A	22	21	1	0	scaffold_1	4771784	4821784
Aspergillus_fumigatus_AF100-11A	17	15	2	0	scaffold_6	3324740	3374740
Aspergillus_fumigatus_AF100-11A	23	21	2	0	scaffold_7	333614	383614
Aspergillus_fumigatus_AF100-11A	21	19	2	0	scaffold_4	3492496	3542496
Aspergillus_fumigatus_AF100-11A	16	15	1	0	scaffold_7	1420388	1470388
Aspergillus_fumigatus_AF100-11A	17	17	0	0	scaffold_6	1611515	1661515
Aspergillus_fumigatus_AF100-11A	20	17	3	0	scaffold_4	2841768	2891768
Aspergillus_fumigatus_AF100-11A	19	17	2	0	scaffold_3	2048881	2098881
Aspergillus_fumigatus_AF100-11A	16	16	0	0	scaffold_6	2804079	2854079
Aspergillus_fumigatus_AF100-11A	16	16	0	0	scaffold_5	973393	1023393
Aspergillus_fumigatus_AF100-11A	19	19	0	0	scaffold_1	2400356	2450356
Aspergillus_fumigatus_AF100-11A	22	14	8	0	scaffold_3	3560666	3610666
Aspergillus_fumigatus_AF100-11A	14	13	1	0	scaffold_6	3545628	3595628
Aspergillus_fumigatus_AF100-11A	25	21	3	1	scaffold_2	4296001	4346001
Aspergillus_fumigatus_AF100-11A	17	15	2	0	scaffold_7	28588	78588
Aspergillus_fumigatus_AF100-11A	17	17	0	0	scaffold_1	717078	767078
Aspergillus_fumigatus_AF100-11A	20	15	5	0	scaffold_4	3772165	3822165
Aspergillus_fumigatus_AF100-11A	18	16	2	0	scaffold_4	1298905	1348905
Aspergillus_fumigatus_AF100-11A	21	18	3	0	scaffold_5	1922586	1972586
Aspergillus_fumigatus_AF100-11A	18	17	1	0	scaffold_2	2286526	2336526
Aspergillus_fumigatus_AF100-11A	22	19	3	0	scaffold_3	354268	404268
Aspergillus_fumigatus_AF100-11A	18	16	2	0	scaffold_4	2365404	2415404
Aspergillus_fumigatus_AF100-11A	9	6	3	0	scaffold_5	2168674	2218674
Aspergillus_fumigatus_AF100-11A	19	18	1	0	scaffold_7	1007881	1057881
Aspergillus_fumigatus_AF100-11A	18	16	2	0	scaffold_2	4656124	4706124
Aspergillus_fumigatus_AF100-11A	20	19	1	0	scaffold_7	1464675	1514675
Aspergillus_fumigatus_AF100-11A	23	19	4	0	scaffold_3	72199	122199
Aspergillus_fumigatus_AF100-11A	21	18	3	0	scaffold_1	1449577	1499577
Aspergillus_fumigatus_AF100-11A	18	17	1	0	scaffold_6	1452787	1502787
Aspergillus_fumigatus_AF100-11A	22	19	3	0	scaffold_7	365969	415969
Aspergillus_fumigatus_AF100-11A	18	18	0	0	scaffold_1	2230416	2280416
Aspergillus_fumigatus_AF100-11A	16	15	1	0	scaffold_1	4042533	4092533
Aspergillus_fumigatus_AF100-11A	18	17	1	0	scaffold_2	3736432	3786432
Aspergillus_fumigatus_AF100-11A	24	21	3	0	scaffold_4	3708309	3758309
Aspergillus_fumigatus_AF100-11A	22	19	3	0	scaffold_3	355668	405668
Aspergillus_fumigatus_AF100-11A	16	16	0	0	scaffold_6	2771052	2821052
Aspergillus_fumigatus_AF100-11A	15	13	2	0	scaffold_1	2038462	2088462
Aspergillus_fumigatus_AF100-11A	22	19	3	0	scaffold_1	1283543	1333543
Aspergillus_fumigatus_AF100-11A	23	21	2	0	scaffold_8	1043244	1093244
Aspergillus_fumigatus_AF100-11A	19	17	2	0	scaffold_6	2039033	2089033
Aspergillus_fumigatus_AF100-11A	17	17	0	0	scaffold_2	938601	988601
Aspergillus_fumigatus_AF100-11A	17	14	3	0	scaffold_5	2876157	2926157
Aspergillus_fumigatus_AF100-11A	14	13	1	0	scaffold_6	2635925	2685925
Aspergillus_fumigatus_AF100-11A	22	21	1	0	scaffold_5	3533931	3583931
Aspergillus_fumigatus_AF100-11A	26	24	2	0	scaffold_6	2576188	2626188
Aspergillus_fumigatus_AF100-11A	24	21	3	0	scaffold_5	2630935	2680935
Aspergillus_fumigatus_AF100-11A	21	20	1	0	scaffold_8	1092107	1142107
Aspergillus_fumigatus_AF100-11A	18	16	2	0	scaffold_2	1318543	1368543
Aspergillus_fumigatus_AF100-11A	19	15	4	0	scaffold_3	762872	812872
Aspergillus_fumigatus_AF100-11A	18	17	1	0	scaffold_5	3265590	3315590
Aspergillus_fumigatus_AF100-11A	15	14	1	0	scaffold_8	1262088	1312088
Aspergillus_fumigatus_AF100-11A	24	21	3	0	scaffold_8	1078284	1128284
Aspergillus_fumigatus_AF100-11A	26	24	2	0	scaffold_6	2576216	2626216
Aspergillus_fumigatus_AF100-11A	27	22	4	1	scaffold_3	442345	492345
Aspergillus_fumigatus_AF100-11A	16	14	2	0	scaffold_4	1885825	1935825
Aspergillus_fumigatus_AF100-11A	17	15	2	0	scaffold_8	999916	1049916
Aspergillus_fumigatus_AF100-11A	18	16	2	0	scaffold_4	2353239	2403239
Aspergillus_fumigatus_AF100-11A	29	19	10	0	scaffold_1	90337	140337
Aspergillus_fumigatus_AF100-11A	18	14	4	0	scaffold_1	3670658	3720658
Aspergillus_fumigatus_AF100-11A	22	18	4	0	scaffold_1	4219022	4269022
Aspergillus_fumigatus_AF100-11A	22	19	3	0	scaffold_3	366991	416991
Aspergillus_fumigatus_AF100-11A	21	17	4	0	scaffold_5	92952	142952
Aspergillus_fumigatus_AF100-11A	17	16	1	0	scaffold_3	3107175	3157175
Aspergillus_fumigatus_AF100-11A	14	14	0	0	scaffold_6	2177148	2227148
Aspergillus_fumigatus_AF100-11A	18	13	5	0	scaffold_5	2895376	2945376
Aspergillus_fumigatus_AF100-11A	16	15	1	0	scaffold_2	4534003	4584003
Aspergillus_fumigatus_AF100-11A	21	20	1	0	scaffold_2	3022326	3072326
Aspergillus_fumigatus_AF100-11A	20	18	2	0	scaffold_2	2353827	2403827
Aspergillus_fumigatus_AF100-11A	21	20	1	0	scaffold_4	1549149	1599149
Aspergillus_fumigatus_AF100-11A	19	17	2	0	scaffold_2	3064089	3114089
Aspergillus_fumigatus_AF100-11A	18	18	0	0	scaffold_4	2910764	2960764
Aspergillus_fumigatus_AF100-11A	20	18	2	0	scaffold_1	3998547	4048547
Aspergillus_fumigatus_AF100-11A	27	19	8	0	scaffold_4	3656394	3706394
Aspergillus_fumigatus_AF100-11A	17	15	2	0	scaffold_6	985829	1035829
Aspergillus_fumigatus_AF100-11A	19	17	2	0	scaffold_3	1874259	1924259
Aspergillus_fumigatus_AF100-11A	18	17	1	0	scaffold_5	3265970	3315970
Aspergillus_fumigatus_AF100-11A	17	15	2	0	scaffold_5	1750599	1800599
Aspergillus_fumigatus_AF100-11A	12	11	1	0	scaffold_2	4259419	4309419
Aspergillus_fumigatus_AF100-11A	19	17	2	0	scaffold_2	4507778	4557778
Aspergillus_fumigatus_AF100-11A	19	19	0	0	scaffold_1	1399152	1449152
Aspergillus_fumigatus_AF100-11A	21	17	4	0	scaffold_7	1168793	1218793
Aspergillus_fumigatus_AF100-11A	16	15	1	0	scaffold_4	1531320	1581320
Aspergillus_fumigatus_AF100-11A	4	4	0	0	scaffold_2	2004891	2054891
Aspergillus_fumigatus_AF100-11A	17	17	0	0	scaffold_6	1382649	1432649
Aspergillus_fumigatus_AF100-11A	19	16	3	0	scaffold_6	581973	631973
Aspergillus_fumigatus_AF100-11A	22	18	4	0	scaffold_4	3354046	3404046
Aspergillus_fumigatus_AF100-11A	18	17	1	0	scaffold_7	1321358	1371358
Aspergillus_fumigatus_AF100-11A	18	17	1	0	scaffold_5	1789992	1839992
Aspergillus_fumigatus_AF100-11A	18	18	0	0	scaffold_3	1098680	1148680
Aspergillus_fumigatus_AF100-11A	22	22	0	0	scaffold_4	2887099	2937099
Aspergillus_fumigatus_AF100-11A	18	18	0	0	scaffold_2	1148551	1198551
Aspergillus_fumigatus_AF100-11A	17	14	3	0	scaffold_6	2461815	2511815
Aspergillus_fumigatus_AF100-11A	21	21	0	0	scaffold_2	4092323	4142323
Aspergillus_fumigatus_AF100-11A	19	16	3	0	scaffold_4	117546	167546
Aspergillus_fumigatus_AF100-11A	17	16	1	0	scaffold_6	1076664	1126664
Aspergillus_fumigatus_AF100-11A	17	16	1	0	scaffold_3	2111208	2161208
Aspergillus_fumigatus_AF100-11A	27	25	2	0	scaffold_5	2121365	2171365
Aspergillus_fumigatus_AF100-11A	18	15	3	0	scaffold_1	4190883	4240883
Aspergillus_fumigatus_AF100-11A	15	15	0	0	scaffold_2	952112	1002112
Aspergillus_fumigatus_AF100-11A	20	14	6	0	scaffold_2	2760102	2810102
Aspergillus_fumigatus_AF100-11A	8	8	0	0	scaffold_1	1829528	1879528
Aspergillus_fumigatus_AF100-11A	21	21	0	0	scaffold_1	2244859	2294859
Aspergillus_fumigatus_AF100-11A	16	16	0	0	scaffold_2	815895	865895
Aspergillus_fumigatus_AF100-11A	18	16	2	0	scaffold_6	1790861	1840861
Aspergillus_fumigatus_AF100-11A	19	18	1	0	scaffold_5	2086267	2136267
Aspergillus_fumigatus_AF100-11A	20	17	3	0	scaffold_2	3095241	3145241
Aspergillus_fumigatus_AF100-11A	14	12	2	0	scaffold_5	290341	340341
Aspergillus_fumigatus_AF100-11A	18	16	2	0	scaffold_8	1317942	1367942
Aspergillus_fumigatus_AF100-11A	21	18	3	0	scaffold_8	56443	106443
Aspergillus_fumigatus_AF100-11A	18	16	2	0	scaffold_4	1188966	1238966
Aspergillus_fumigatus_AF100-11A	21	18	3	0	scaffold_8	254603	304603
Aspergillus_fumigatus_AF100-11A	23	22	1	0	scaffold_4	913158	963158
Aspergillus_fumigatus_AF100-11A	16	14	2	0	scaffold_4	1173685	1223685
Aspergillus_fumigatus_AF100-11A	17	16	1	0	scaffold_2	1174024	1224024
Aspergillus_fumigatus_AF100-11A	18	15	3	0	scaffold_2	4648514	4698514
Aspergillus_fumigatus_AF100-11A	17	15	2	0	scaffold_4	865017	915017
Aspergillus_fumigatus_AF100-11A	22	20	2	0	scaffold_3	3818704	3868704
Aspergillus_fumigatus_AF100-11A	18	16	2	0	scaffold_1	1621900	1671900
Aspergillus_fumigatus_AF100-11A	15	11	4	0	scaffold_5	2970020	3020020
Aspergillus_fumigatus_AF100-11A	22	21	1	0	scaffold_6	298969	348969
Aspergillus_fumigatus_AF100-11A	22	17	5	0	scaffold_3	90790	140790
Aspergillus_fumigatus_AF100-11A	12	12	0	0	scaffold_2	2986531	3036531
Aspergillus_fumigatus_AF100-11A	16	13	3	0	scaffold_6	2483140	2533140
Aspergillus_fumigatus_AF100-11A	12	10	2	0	scaffold_1	3649078	3699078
Aspergillus_fumigatus_AF100-11A	22	20	2	0	scaffold_7	165352	215352
Aspergillus_fumigatus_AF100-11A	7	5	2	0	scaffold_2	4734392	4784392
Aspergillus_fumigatus_AF100-11A	0	0	0	0	scaffold_6	219709	269709
Aspergillus_fumigatus_AF100-11A	16	15	1	0	scaffold_5	830297	880297
Aspergillus_fumigatus_AF100-11A	18	18	0	0	scaffold_4	2313671	2363671
Aspergillus_fumigatus_AF100-11A	20	18	2	0	scaffold_8	1032531	1082531
Aspergillus_fumigatus_AF100-11A	15	15	0	0	scaffold_4	1921114	1971114
Aspergillus_fumigatus_AF100-11A	20	17	3	0	scaffold_4	471644	521644
Aspergillus_fumigatus_AF100-11A	18	15	3	0	scaffold_6	131036	181036
Aspergillus_fumigatus_AF100-11A	19	17	2	0	scaffold_1	4634745	4684745
Aspergillus_fumigatus_AF100-11A	23	22	1	0	scaffold_4	992100	1042100
Aspergillus_fumigatus_AF100-11A	17	16	1	0	scaffold_4	3010909	3060909
Aspergillus_fumigatus_AF100-11A	2	2	0	0	scaffold_5	178996	228996
Aspergillus_fumigatus_AF100-11A	18	16	2	0	scaffold_6	3313237	3363237
Aspergillus_fumigatus_AF100-11A	24	19	5	0	scaffold_3	308209	358209
Aspergillus_fumigatus_AF100-11A	13	13	0	0	scaffold_6	2163615	2213615
Aspergillus_fumigatus_AF100-11A	17	16	1	0	scaffold_2	1638959	1688959
Aspergillus_fumigatus_AF100-11A	21	19	2	0	scaffold_1	1247211	1297211
Aspergillus_fumigatus_AF100-11A	16	16	0	0	scaffold_4	2706043	2756043
Aspergillus_fumigatus_AF100-11A	18	17	1	0	scaffold_2	3251267	3301267
Aspergillus_fumigatus_AF100-11A	14	12	2	0	scaffold_2	1274870	1324870
Aspergillus_fumigatus_AF100-11A	17	15	2	0	scaffold_7	1309180	1359180
Aspergillus_fumigatus_AF100-11A	16	16	0	0	scaffold_5	3691583	3741583
Aspergillus_fumigatus_AF100-11A	18	15	3	0	scaffold_5	1354167	1404167
Aspergillus_fumigatus_AF100-11A	18	18	0	0	scaffold_1	763763	813763
Aspergillus_fumigatus_AF100-11A	19	19	0	0	scaffold_5	3183403	3233403
Aspergillus_fumigatus_AF100-11A	14	11	3	0	scaffold_2	4157845	4207845
Aspergillus_fumigatus_AF100-11A	16	14	2	0	scaffold_1	2972586	3022586
Aspergillus_fumigatus_AF100-11A	16	16	0	0	scaffold_3	2822569	2872569
Aspergillus_fumigatus_AF100-11A	27	17	10	0	scaffold_5	19610	69610
Aspergillus_fumigatus_AF100-11A	17	15	2	0	scaffold_4	828500	878500
Aspergillus_fumigatus_AF100-11A	19	17	2	0	scaffold_1	253931	303931
Aspergillus_fumigatus_AF100-11A	23	22	1	0	scaffold_2	2200777	2250777
Aspergillus_fumigatus_AF100-11A	18	16	2	0	scaffold_3	3220341	3270341
Aspergillus_fumigatus_AF100-11A	18	15	3	0	scaffold_2	4646372	4696372
Aspergillus_fumigatus_AF100-11A	21	20	1	0	scaffold_7	928556	978556
Aspergillus_fumigatus_AF100-11A	19	18	1	0	scaffold_8	643728	693728
Aspergillus_fumigatus_AF100-11A	22	19	3	0	scaffold_2	1387418	1437418
Aspergillus_fumigatus_AF100-11A	18	15	3	0	scaffold_4	3463187	3513187
Aspergillus_fumigatus_AF100-11A	24	22	2	0	scaffold_7	1657695	1707695
Aspergillus_fumigatus_AF100-11A	21	19	2	0	scaffold_2	1328278	1378278
Aspergillus_fumigatus_AF100-11A	16	16	0	0	scaffold_3	1401523	1451523
Aspergillus_fumigatus_AF100-11A	20	19	1	0	scaffold_8	1178628	1228628
Aspergillus_fumigatus_AF100-11A	17	17	0	0	scaffold_3	2592222	2642222
Aspergillus_fumigatus_AF100-11A	21	19	2	0	scaffold_5	426444	476444
Aspergillus_fumigatus_AF100-11A	20	20	0	0	scaffold_8	621738	671738
Aspergillus_fumigatus_AF100-11A	6	6	0	0	scaffold_6	1160548	1210548
Aspergillus_fumigatus_AF100-11A	4	4	0	0	scaffold_5	2180683	2230683
Aspergillus_fumigatus_AF100-11A	16	14	2	0	scaffold_6	3543244	3593244
Aspergillus_fumigatus_AF100-11A	23	21	2	0	scaffold_5	768944	818944
Aspergillus_fumigatus_AF100-11A	19	17	2	0	scaffold_6	714779	764779
Aspergillus_fumigatus_AF100-11A	20	20	0	0	scaffold_2	402165	452165
Aspergillus_fumigatus_AF100-11A	18	18	0	0	scaffold_1	2548018	2598018
Aspergillus_fumigatus_AF100-11A	17	17	0	0	scaffold_5	2041506	2091506
Aspergillus_fumigatus_AF100-11A	14	13	1	0	scaffold_6	2634537	2684537
Aspergillus_fumigatus_AF100-11A	20	19	1	0	scaffold_8	1186996	1236996
Aspergillus_fumigatus_AF100-11A	23	20	3	0	scaffold_7	1663610	1713610
Aspergillus_fumigatus_AF100-11A	20	19	1	0	scaffold_1	2464563	2514563
Aspergillus_fumigatus_AF100-11A	18	16	2	0	scaffold_1	902713	952713
Aspergillus_fumigatus_AF100-11A	10	10	0	0	scaffold_2	2501784	2551784
Aspergillus_fumigatus_AF100-11A	20	18	2	0	scaffold_3	1874696	1924696
Aspergillus_fumigatus_AF100-11A	20	19	1	0	scaffold_1	418298	468298
Aspergillus_fumigatus_AF100-11A	13	13	0	0	scaffold_2	2960851	3010851
Aspergillus_fumigatus_AF100-11A	23	21	2	0	scaffold_2	2362540	2412540
Aspergillus_fumigatus_AF100-11A	16	16	0	0	scaffold_2	804421	854421
Aspergillus_fumigatus_AF100-11A	16	13	3	0	scaffold_2	3822984	3872984
Aspergillus_fumigatus_AF100-11A	19	19	0	0	scaffold_1	803089	853089
Aspergillus_fumigatus_AF100-11A	18	15	3	0	scaffold_8	847701	897701
Aspergillus_fumigatus_AF100-11A	20	20	0	0	scaffold_1	1596076	1646076
Aspergillus_fumigatus_AF100-11A	20	19	1	0	scaffold_7	1463687	1513687
Aspergillus_fumigatus_AF100-11A	2	1	1	0	scaffold_4	8847	58847
Aspergillus_fumigatus_AF100-11A	15	15	0	0	scaffold_1	1222484	1272484
Aspergillus_fumigatus_AF100-11A	23	20	3	0	scaffold_1	240998	290998
Aspergillus_fumigatus_AF100-11A	23	23	0	0	scaffold_6	2562488	2612488
Aspergillus_fumigatus_AF100-11A	18	16	2	0	scaffold_1	2479677	2529677
Aspergillus_fumigatus_AF100-11A	19	18	1	0	scaffold_4	1589627	1639627
Aspergillus_fumigatus_AF100-11A	23	22	1	0	scaffold_3	3491162	3541162
Aspergillus_fumigatus_AF100-11A	19	18	1	0	scaffold_4	410680	460680
Aspergillus_fumigatus_AF100-11A	23	21	2	0	scaffold_3	3192455	3242455
Aspergillus_fumigatus_AF100-11A	21	19	2	0	scaffold_2	645212	695212
Aspergillus_fumigatus_AF100-11A	26	22	4	0	scaffold_7	1647933	1697933
Aspergillus_fumigatus_AF100-11A	22	22	0	0	scaffold_6	2975845	3025845
Aspergillus_fumigatus_AF100-11A	13	12	1	0	scaffold_7	854327	904327
Aspergillus_fumigatus_AF100-11A	9	9	0	0	scaffold_6	2821100	2871100
Aspergillus_fumigatus_AF100-11A	16	14	2	0	scaffold_7	498493	548493
Aspergillus_fumigatus_AF100-11A	16	14	2	0	scaffold_8	657755	707755
Aspergillus_fumigatus_AF100-11A	18	18	0	0	scaffold_1	748378	798378
Aspergillus_fumigatus_AF100-11A	11	11	0	0	scaffold_2	3497972	3547972
Aspergillus_fumigatus_AF100-11A	19	16	3	0	scaffold_1	356281	406281
Aspergillus_fumigatus_AF100-11A	9	5	4	0	scaffold_2	106632	156632
Aspergillus_fumigatus_AF100-11A	21	18	3	0	scaffold_3	920183	970183
Aspergillus_fumigatus_AF100-11A	19	17	2	0	scaffold_1	4672106	4722106
Aspergillus_fumigatus_AF100-11A	20	19	1	0	scaffold_3	2785791	2835791
Aspergillus_fumigatus_AF100-11A	18	14	4	0	scaffold_3	765131	815131
Aspergillus_fumigatus_AF100-11A	13	13	0	0	scaffold_2	949229	999229
Aspergillus_fumigatus_AF100-11A	18	18	0	0	scaffold_4	2680086	2730086
Aspergillus_fumigatus_AF100-11A	17	17	0	0	scaffold_4	706269	756269
Aspergillus_fumigatus_AF100-11A	17	15	2	0	scaffold_1	1512598	1562598
Aspergillus_fumigatus_AF100-11A	17	16	1	0	scaffold_2	1634799	1684799
Aspergillus_fumigatus_AF100-11A	22	15	7	0	scaffold_3	961085	1011085
Aspergillus_fumigatus_AF100-11A	22	15	7	0	scaffold_3	3564421	3614421
Aspergillus_fumigatus_AF100-11A	18	18	0	0	scaffold_2	1129157	1179157
Aspergillus_fumigatus_AF100-11A	19	19	0	0	scaffold_8	1200352	1250352
Aspergillus_fumigatus_AF100-11A	19	17	2	0	scaffold_1	4676119	4726119
Aspergillus_fumigatus_AF100-11A	13	13	0	0	scaffold_1	2812579	2862579
Aspergillus_fumigatus_AF100-11A	3	2	1	0	scaffold_4	12878	62878
Aspergillus_fumigatus_AF100-11A	23	17	6	0	scaffold_7	1176232	1226232
Aspergillus_fumigatus_AF100-11A	19	16	3	0	scaffold_8	1551130	1601130
Aspergillus_fumigatus_AF100-11A	18	14	4	0	scaffold_4	3552718	3602718
Aspergillus_fumigatus_AF100-11A	15	13	2	0	scaffold_5	2339099	2389099
Aspergillus_fumigatus_AF100-11A	15	15	0	0	scaffold_6	2136999	2186999
Aspergillus_fumigatus_AF100-11A	8	2	6	0	scaffold_2	80792	130792
Aspergillus_fumigatus_AF100-11A	19	19	0	0	scaffold_5	627676	677676
Aspergillus_fumigatus_AF100-11A	21	19	2	0	scaffold_2	1357641	1407641
Aspergillus_fumigatus_AF100-11A	18	2	16	0	scaffold_3	651271	701271
Aspergillus_fumigatus_AF100-11A	18	17	1	0	scaffold_1	3482968	3532968
Aspergillus_fumigatus_AF100-11A	19	17	2	0	scaffold_5	722019	772019
Aspergillus_fumigatus_AF100-11A	21	21	0	0	scaffold_6	1397872	1447872
Aspergillus_fumigatus_AF100-11A	19	18	1	0	scaffold_5	733061	783061
Aspergillus_fumigatus_AF100-11A	19	15	4	0	scaffold_8	1540929	1590929
Aspergillus_fumigatus_AF100-11A	20	19	1	0	scaffold_4	2341754	2391754
Aspergillus_fumigatus_AF100-11A	15	13	2	0	scaffold_2	1976623	2026623
Aspergillus_fumigatus_AF100-11A	16	16	0	0	scaffold_2	4052189	4102189
Aspergillus_fumigatus_AF100-11A	21	19	2	0	scaffold_2	2855387	2905387
Aspergillus_fumigatus_AF100-11A	24	22	2	0	scaffold_1	3382444	3432444
Aspergillus_fumigatus_AF100-11A	17	15	2	0	scaffold_1	3755567	3805567
Aspergillus_fumigatus_AF100-11A	17	17	0	0	scaffold_4	2703975	2753975
Aspergillus_fumigatus_AF100-11A	16	11	5	0	scaffold_5	213956	263956
Aspergillus_fumigatus_AF100-11A	24	24	0	0	scaffold_6	1408480	1458480
Aspergillus_fumigatus_AF100-11A	19	18	1	0	scaffold_2	1758216	1808216
Aspergillus_fumigatus_AF100-11A	20	19	1	0	scaffold_7	950001	1000001
Aspergillus_fumigatus_AF100-11A	13	13	0	0	scaffold_7	658644	708644
Aspergillus_fumigatus_AF100-11A	17	13	4	0	scaffold_1	2075155	2125155
Aspergillus_fumigatus_AF100-11A	17	17	0	0	scaffold_2	1115929	1165929
Aspergillus_fumigatus_AF100-11A	18	16	2	0	scaffold_1	2991519	3041519
Aspergillus_fumigatus_AF100-11A	20	19	1	0	scaffold_5	1164505	1214505
Aspergillus_fumigatus_AF100-11A	0	0	0	0	scaffold_5	2217429	2267429
Aspergillus_fumigatus_AF100-11A	16	13	3	0	scaffold_8	1488405	1538405
Aspergillus_fumigatus_AF100-11A	16	13	3	0	scaffold_7	1104871	1154871
Aspergillus_fumigatus_AF100-11A	19	18	1	0	scaffold_2	3667740	3717740
Aspergillus_fumigatus_AF100-11A	20	19	1	0	scaffold_5	592242	642242
Aspergillus_fumigatus_AF100-11A	26	19	7	0	scaffold_4	3645786	3695786
Aspergillus_fumigatus_AF100-11A	20	18	2	0	scaffold_5	1046355	1096355
Aspergillus_fumigatus_AF100-11A	18	16	2	0	scaffold_4	2224086	2274086
Aspergillus_fumigatus_AF100-11A	19	14	5	0	scaffold_6	642231	692231
Aspergillus_fumigatus_AF100-11A	19	17	2	0	scaffold_2	755059	805059
Aspergillus_fumigatus_AF100-11A	16	14	1	1	scaffold_6	3449560	3499560
Aspergillus_fumigatus_AF100-11A	18	13	5	0	scaffold_3	967130	1017130
Aspergillus_fumigatus_AF100-11A	17	14	3	0	scaffold_4	1874746	1924746
Aspergillus_fumigatus_AF100-11A	24	21	3	0	scaffold_3	75195	125195
Aspergillus_fumigatus_AF100-11A	15	14	1	0	scaffold_6	2623639	2673639
Aspergillus_fumigatus_AF100-11A	18	16	2	0	scaffold_1	3508464	3558464
Aspergillus_fumigatus_AF100-11A	19	19	0	0	scaffold_4	3117298	3167298
Aspergillus_fumigatus_AF100-11A	16	16	0	0	scaffold_5	1441584	1491584
Aspergillus_fumigatus_AF100-11A	22	21	1	0	scaffold_2	4331885	4381885
Aspergillus_fumigatus_AF100-11A	22	20	2	0	scaffold_5	1020759	1070759
Aspergillus_fumigatus_AF100-11A	21	20	1	0	scaffold_5	1060539	1110539
Aspergillus_fumigatus_AF100-11A	19	12	7	0	scaffold_7	1691384	1741384
Aspergillus_fumigatus_AF100-11A	20	19	1	0	scaffold_3	1753015	1803015
Aspergillus_fumigatus_AF100-11A	19	18	1	0	scaffold_3	1256206	1306206
Aspergillus_fumigatus_AF100-11A	21	20	1	0	scaffold_1	946878	996878
Aspergillus_fumigatus_AF100-11A	16	10	6	0	scaffold_3	3585737	3635737
Aspergillus_fumigatus_AF100-11A	20	20	0	0	scaffold_1	649766	699766
Aspergillus_fumigatus_AF100-11A	16	16	0	0	scaffold_6	2802499	2852499
Aspergillus_fumigatus_AF100-11A	17	16	1	0	scaffold_2	1174492	1224492
Aspergillus_fumigatus_AF100-11A	23	21	2	0	scaffold_5	3587417	3637417
Aspergillus_fumigatus_AF100-11A	18	16	2	0	scaffold_3	1017342	1067342
Aspergillus_fumigatus_AF100-11A	21	21	0	0	scaffold_2	1710980	1760980
Aspergillus_fumigatus_AF100-11A	29	23	6	0	scaffold_7	1617945	1667945
Aspergillus_fumigatus_AF100-11A	18	18	0	0	scaffold_1	753423	803423
Aspergillus_fumigatus_AF100-11A	19	18	1	0	scaffold_2	1814085	1864085
Aspergillus_fumigatus_AF100-11A	20	20	0	0	scaffold_2	1750358	1800358
Aspergillus_fumigatus_AF100-11A	18	17	1	0	scaffold_1	2717129	2767129
Aspergillus_fumigatus_AF100-11A	13	12	1	0	scaffold_1	4053862	4103862
Aspergillus_fumigatus_AF100-11A	22	21	1	0	scaffold_8	214330	264330
Aspergillus_fumigatus_AF100-11A	16	13	3	0	scaffold_1	1760110	1810110
Aspergillus_fumigatus_AF100-11A	15	15	0	0	scaffold_4	1143309	1193309
Aspergillus_fumigatus_AF100-11A	15	13	2	0	scaffold_7	1113353	1163353
Aspergillus_fumigatus_AF100-11A	19	18	1	0	scaffold_4	1216984	1266984
Aspergillus_fumigatus_AF100-11A	17	17	0	0	scaffold_1	2568413	2618413
