STRAIN	TOTAL	CORE	ACCESSORY	SINGLETON	CHROM	START	END
Aspergillus_fumigatus_DMC2_AF100-9B	17	17	0	0	scaffold_2	2404259	2454259
Aspergillus_fumigatus_DMC2_AF100-9B	20	16	4	0	scaffold_1	3375890	3425890
Aspergillus_fumigatus_DMC2_AF100-9B	17	13	4	0	scaffold_8	527920	577920
Aspergillus_fumigatus_DMC2_AF100-9B	20	19	1	0	scaffold_3	1329578	1379578
Aspergillus_fumigatus_DMC2_AF100-9B	22	17	5	0	scaffold_3	3013033	3063033
Aspergillus_fumigatus_DMC2_AF100-9B	20	17	3	0	scaffold_2	1557643	1607643
Aspergillus_fumigatus_DMC2_AF100-9B	15	14	1	0	scaffold_2	2857421	2907421
Aspergillus_fumigatus_DMC2_AF100-9B	22	19	3	0	scaffold_4	719622	769622
Aspergillus_fumigatus_DMC2_AF100-9B	20	15	5	0	scaffold_4	3035375	3085375
Aspergillus_fumigatus_DMC2_AF100-9B	21	20	1	0	scaffold_1	1898935	1948935
Aspergillus_fumigatus_DMC2_AF100-9B	21	15	6	0	scaffold_3	2393032	2443032
Aspergillus_fumigatus_DMC2_AF100-9B	22	18	4	0	scaffold_5	275222	325222
Aspergillus_fumigatus_DMC2_AF100-9B	17	17	0	0	scaffold_1	2678272	2728272
Aspergillus_fumigatus_DMC2_AF100-9B	19	17	2	0	scaffold_1	2413525	2463525
Aspergillus_fumigatus_DMC2_AF100-9B	19	18	1	0	scaffold_2	3400998	3450998
Aspergillus_fumigatus_DMC2_AF100-9B	17	14	3	0	scaffold_7	366905	416905
Aspergillus_fumigatus_DMC2_AF100-9B	14	14	0	0	scaffold_6	726986	776986
Aspergillus_fumigatus_DMC2_AF100-9B	10	9	1	0	scaffold_4	2167532	2217532
Aspergillus_fumigatus_DMC2_AF100-9B	18	15	3	0	scaffold_6	35503	85503
Aspergillus_fumigatus_DMC2_AF100-9B	16	16	0	0	scaffold_2	2267490	2317490
Aspergillus_fumigatus_DMC2_AF100-9B	13	11	2	0	scaffold_6	2887529	2937529
Aspergillus_fumigatus_DMC2_AF100-9B	18	18	0	0	scaffold_2	2296732	2346732
Aspergillus_fumigatus_DMC2_AF100-9B	16	15	1	0	scaffold_6	1485441	1535441
Aspergillus_fumigatus_DMC2_AF100-9B	18	15	3	0	scaffold_4	2657817	2707817
Aspergillus_fumigatus_DMC2_AF100-9B	21	19	2	0	scaffold_1	234348	284348
Aspergillus_fumigatus_DMC2_AF100-9B	22	19	3	0	scaffold_2	2097255	2147255
Aspergillus_fumigatus_DMC2_AF100-9B	23	21	2	0	scaffold_1	2986678	3036678
Aspergillus_fumigatus_DMC2_AF100-9B	21	18	3	0	scaffold_2	1047614	1097614
Aspergillus_fumigatus_DMC2_AF100-9B	18	16	2	0	scaffold_7	1466684	1516684
Aspergillus_fumigatus_DMC2_AF100-9B	18	17	1	0	scaffold_2	2336321	2386321
Aspergillus_fumigatus_DMC2_AF100-9B	26	24	2	0	scaffold_1	4783859	4833859
Aspergillus_fumigatus_DMC2_AF100-9B	18	16	2	0	scaffold_2	2846138	2896138
Aspergillus_fumigatus_DMC2_AF100-9B	8	7	1	0	scaffold_5	345447	395447
Aspergillus_fumigatus_DMC2_AF100-9B	19	18	1	0	scaffold_2	3452250	3502250
Aspergillus_fumigatus_DMC2_AF100-9B	15	12	3	0	scaffold_1	1016313	1066313
Aspergillus_fumigatus_DMC2_AF100-9B	6	4	2	0	scaffold_6	1118763	1168763
Aspergillus_fumigatus_DMC2_AF100-9B	18	16	2	0	scaffold_1	1577634	1627634
Aspergillus_fumigatus_DMC2_AF100-9B	16	16	0	0	scaffold_3	3740977	3790977
Aspergillus_fumigatus_DMC2_AF100-9B	21	15	6	0	scaffold_5	201297	251297
Aspergillus_fumigatus_DMC2_AF100-9B	17	17	0	0	scaffold_5	2992169	3042169
Aspergillus_fumigatus_DMC2_AF100-9B	19	16	3	0	scaffold_2	4075022	4125022
Aspergillus_fumigatus_DMC2_AF100-9B	17	15	2	0	scaffold_1	400757	450757
Aspergillus_fumigatus_DMC2_AF100-9B	20	19	1	0	scaffold_8	75644	125644
Aspergillus_fumigatus_DMC2_AF100-9B	18	16	2	0	scaffold_6	256469	306469
Aspergillus_fumigatus_DMC2_AF100-9B	20	15	5	0	scaffold_5	2128343	2178343
Aspergillus_fumigatus_DMC2_AF100-9B	22	20	2	0	scaffold_6	278425	328425
Aspergillus_fumigatus_DMC2_AF100-9B	18	16	2	0	scaffold_6	2388929	2438929
Aspergillus_fumigatus_DMC2_AF100-9B	14	13	1	0	scaffold_1	1124554	1174554
Aspergillus_fumigatus_DMC2_AF100-9B	22	21	1	0	scaffold_7	305372	355372
Aspergillus_fumigatus_DMC2_AF100-9B	20	17	3	0	scaffold_5	3379304	3429304
Aspergillus_fumigatus_DMC2_AF100-9B	23	22	1	0	scaffold_5	1326042	1376042
Aspergillus_fumigatus_DMC2_AF100-9B	24	21	3	0	scaffold_2	1869490	1919490
Aspergillus_fumigatus_DMC2_AF100-9B	22	17	5	0	scaffold_6	2991748	3041748
Aspergillus_fumigatus_DMC2_AF100-9B	19	18	1	0	scaffold_2	2942218	2992218
Aspergillus_fumigatus_DMC2_AF100-9B	23	22	1	0	scaffold_1	4819040	4869040
Aspergillus_fumigatus_DMC2_AF100-9B	20	18	2	0	scaffold_6	1799936	1849936
Aspergillus_fumigatus_DMC2_AF100-9B	19	18	1	0	scaffold_2	572223	622223
Aspergillus_fumigatus_DMC2_AF100-9B	22	19	3	0	scaffold_8	1421762	1471762
Aspergillus_fumigatus_DMC2_AF100-9B	22	21	1	0	scaffold_6	3254396	3304396
Aspergillus_fumigatus_DMC2_AF100-9B	19	17	2	0	scaffold_5	3206350	3256350
Aspergillus_fumigatus_DMC2_AF100-9B	18	18	0	0	scaffold_6	617148	667148
Aspergillus_fumigatus_DMC2_AF100-9B	20	20	0	0	scaffold_2	3772537	3822537
Aspergillus_fumigatus_DMC2_AF100-9B	19	19	0	0	scaffold_4	3094047	3144047
Aspergillus_fumigatus_DMC2_AF100-9B	14	12	2	0	scaffold_4	2287021	2337021
Aspergillus_fumigatus_DMC2_AF100-9B	18	17	1	0	scaffold_3	3048691	3098691
Aspergillus_fumigatus_DMC2_AF100-9B	13	11	2	0	scaffold_2	761778	811778
Aspergillus_fumigatus_DMC2_AF100-9B	17	17	0	0	scaffold_3	3882254	3932254
Aspergillus_fumigatus_DMC2_AF100-9B	17	16	1	0	scaffold_8	1070121	1120121
Aspergillus_fumigatus_DMC2_AF100-9B	22	22	0	0	scaffold_5	1784793	1834793
Aspergillus_fumigatus_DMC2_AF100-9B	9	8	1	0	scaffold_1	2868252	2918252
Aspergillus_fumigatus_DMC2_AF100-9B	23	22	1	0	scaffold_2	363315	413315
Aspergillus_fumigatus_DMC2_AF100-9B	18	18	0	0	scaffold_4	2049469	2099469
Aspergillus_fumigatus_DMC2_AF100-9B	15	14	1	0	scaffold_3	1876562	1926562
Aspergillus_fumigatus_DMC2_AF100-9B	23	22	1	0	scaffold_1	4820757	4870757
Aspergillus_fumigatus_DMC2_AF100-9B	20	16	4	0	scaffold_8	536353	586353
Aspergillus_fumigatus_DMC2_AF100-9B	21	18	3	0	scaffold_3	4212059	4262059
Aspergillus_fumigatus_DMC2_AF100-9B	20	17	3	0	scaffold_4	647843	697843
Aspergillus_fumigatus_DMC2_AF100-9B	18	15	3	0	scaffold_2	2442850	2492850
Aspergillus_fumigatus_DMC2_AF100-9B	15	14	1	0	scaffold_1	3026777	3076777
Aspergillus_fumigatus_DMC2_AF100-9B	13	13	0	0	scaffold_1	3949244	3999244
Aspergillus_fumigatus_DMC2_AF100-9B	28	23	5	0	scaffold_7	1858133	1908133
Aspergillus_fumigatus_DMC2_AF100-9B	20	15	5	0	scaffold_2	2466015	2516015
Aspergillus_fumigatus_DMC2_AF100-9B	19	18	1	0	scaffold_5	1875705	1925705
Aspergillus_fumigatus_DMC2_AF100-9B	20	19	1	0	scaffold_7	1275411	1325411
Aspergillus_fumigatus_DMC2_AF100-9B	15	15	0	0	scaffold_3	3527841	3577841
Aspergillus_fumigatus_DMC2_AF100-9B	18	16	2	0	scaffold_5	559225	609225
Aspergillus_fumigatus_DMC2_AF100-9B	18	17	1	0	scaffold_8	313066	363066
Aspergillus_fumigatus_DMC2_AF100-9B	1	1	0	0	scaffold_6	1149510	1199510
Aspergillus_fumigatus_DMC2_AF100-9B	24	21	3	0	scaffold_3	890495	940495
Aspergillus_fumigatus_DMC2_AF100-9B	16	15	1	0	scaffold_6	1837693	1887693
Aspergillus_fumigatus_DMC2_AF100-9B	17	17	0	0	scaffold_6	1060017	1110017
Aspergillus_fumigatus_DMC2_AF100-9B	17	16	1	0	scaffold_8	1222392	1272392
Aspergillus_fumigatus_DMC2_AF100-9B	21	21	0	0	scaffold_2	3787333	3837333
Aspergillus_fumigatus_DMC2_AF100-9B	21	17	4	0	scaffold_4	2460306	2510306
Aspergillus_fumigatus_DMC2_AF100-9B	21	20	1	0	scaffold_3	351408	401408
Aspergillus_fumigatus_DMC2_AF100-9B	20	0	20	0	scaffold_3	1105741	1155741
Aspergillus_fumigatus_DMC2_AF100-9B	15	12	3	0	scaffold_3	3176397	3226397
Aspergillus_fumigatus_DMC2_AF100-9B	16	15	1	0	scaffold_5	2432252	2482252
Aspergillus_fumigatus_DMC2_AF100-9B	20	17	3	0	scaffold_3	3603381	3653381
Aspergillus_fumigatus_DMC2_AF100-9B	24	20	4	0	scaffold_3	1575396	1625396
Aspergillus_fumigatus_DMC2_AF100-9B	18	17	1	0	scaffold_3	2162889	2212889
Aspergillus_fumigatus_DMC2_AF100-9B	22	21	1	0	scaffold_8	682904	732904
Aspergillus_fumigatus_DMC2_AF100-9B	20	18	2	0	scaffold_5	1989979	2039979
Aspergillus_fumigatus_DMC2_AF100-9B	18	18	0	0	scaffold_6	1968679	2018679
Aspergillus_fumigatus_DMC2_AF100-9B	19	19	0	0	scaffold_1	3434140	3484140
Aspergillus_fumigatus_DMC2_AF100-9B	0	0	0	0	scaffold_2	1760471	1810471
Aspergillus_fumigatus_DMC2_AF100-9B	18	16	2	0	scaffold_4	3063421	3113421
Aspergillus_fumigatus_DMC2_AF100-9B	21	17	4	0	scaffold_3	191963	241963
Aspergillus_fumigatus_DMC2_AF100-9B	13	12	1	0	scaffold_1	1120831	1170831
Aspergillus_fumigatus_DMC2_AF100-9B	20	16	4	0	scaffold_5	1460736	1510736
Aspergillus_fumigatus_DMC2_AF100-9B	16	15	1	0	scaffold_6	805639	855639
Aspergillus_fumigatus_DMC2_AF100-9B	18	16	2	0	scaffold_3	1313854	1363854
Aspergillus_fumigatus_DMC2_AF100-9B	21	20	1	0	scaffold_4	2786314	2836314
Aspergillus_fumigatus_DMC2_AF100-9B	19	17	2	0	scaffold_2	2059625	2109625
Aspergillus_fumigatus_DMC2_AF100-9B	14	12	2	0	scaffold_8	1377562	1427562
Aspergillus_fumigatus_DMC2_AF100-9B	10	10	0	0	scaffold_4	2233164	2283164
Aspergillus_fumigatus_DMC2_AF100-9B	25	21	4	0	scaffold_2	143073	193073
Aspergillus_fumigatus_DMC2_AF100-9B	21	18	3	0	scaffold_2	2523895	2573895
Aspergillus_fumigatus_DMC2_AF100-9B	19	17	2	0	scaffold_6	376658	426658
Aspergillus_fumigatus_DMC2_AF100-9B	18	7	11	0	scaffold_1	4311756	4361756
Aspergillus_fumigatus_DMC2_AF100-9B	16	15	1	0	scaffold_3	547313	597313
Aspergillus_fumigatus_DMC2_AF100-9B	17	8	9	0	scaffold_4	26050	76050
Aspergillus_fumigatus_DMC2_AF100-9B	23	20	3	0	scaffold_4	3013180	3063180
Aspergillus_fumigatus_DMC2_AF100-9B	23	23	0	0	scaffold_1	3841206	3891206
Aspergillus_fumigatus_DMC2_AF100-9B	20	18	2	0	scaffold_1	2551611	2601611
Aspergillus_fumigatus_DMC2_AF100-9B	25	12	13	0	scaffold_5	2175161	2225161
Aspergillus_fumigatus_DMC2_AF100-9B	21	16	5	0	scaffold_2	4122514	4172514
Aspergillus_fumigatus_DMC2_AF100-9B	16	14	2	0	scaffold_4	527951	577951
Aspergillus_fumigatus_DMC2_AF100-9B	24	22	2	0	scaffold_4	977029	1027029
Aspergillus_fumigatus_DMC2_AF100-9B	17	16	1	0	scaffold_3	1991441	2041441
Aspergillus_fumigatus_DMC2_AF100-9B	18	17	1	0	scaffold_4	1817688	1867688
Aspergillus_fumigatus_DMC2_AF100-9B	21	19	2	0	scaffold_3	2933556	2983556
Aspergillus_fumigatus_DMC2_AF100-9B	20	18	2	0	scaffold_2	1506305	1556305
Aspergillus_fumigatus_DMC2_AF100-9B	20	17	3	0	scaffold_2	1265957	1315957
Aspergillus_fumigatus_DMC2_AF100-9B	21	20	1	0	scaffold_3	2310050	2360050
Aspergillus_fumigatus_DMC2_AF100-9B	15	13	2	0	scaffold_7	770658	820658
Aspergillus_fumigatus_DMC2_AF100-9B	19	19	0	0	scaffold_6	2036778	2086778
Aspergillus_fumigatus_DMC2_AF100-9B	17	12	5	0	scaffold_1	3550874	3600874
Aspergillus_fumigatus_DMC2_AF100-9B	21	20	1	0	scaffold_7	1739008	1789008
Aspergillus_fumigatus_DMC2_AF100-9B	18	16	2	0	scaffold_4	1960107	2010107
Aspergillus_fumigatus_DMC2_AF100-9B	17	15	2	0	scaffold_6	3106298	3156298
Aspergillus_fumigatus_DMC2_AF100-9B	21	15	6	0	scaffold_1	4596847	4646847
Aspergillus_fumigatus_DMC2_AF100-9B	19	19	0	0	scaffold_3	347772	397772
Aspergillus_fumigatus_DMC2_AF100-9B	4	4	0	0	scaffold_8	841529	891529
Aspergillus_fumigatus_DMC2_AF100-9B	22	16	6	0	scaffold_3	4333300	4383300
Aspergillus_fumigatus_DMC2_AF100-9B	13	12	1	0	scaffold_3	3669989	3719989
Aspergillus_fumigatus_DMC2_AF100-9B	17	17	0	0	scaffold_6	1995720	2045720
Aspergillus_fumigatus_DMC2_AF100-9B	26	20	6	0	scaffold_6	2500096	2550096
Aspergillus_fumigatus_DMC2_AF100-9B	19	17	2	0	scaffold_5	1548113	1598113
Aspergillus_fumigatus_DMC2_AF100-9B	22	22	0	0	scaffold_8	1718665	1768665
Aspergillus_fumigatus_DMC2_AF100-9B	11	10	1	0	scaffold_3	3833381	3883381
Aspergillus_fumigatus_DMC2_AF100-9B	21	20	1	0	scaffold_4	2090310	2140310
Aspergillus_fumigatus_DMC2_AF100-9B	23	21	2	0	scaffold_2	214152	264152
Aspergillus_fumigatus_DMC2_AF100-9B	20	19	1	0	scaffold_3	734933	784933
Aspergillus_fumigatus_DMC2_AF100-9B	18	18	0	0	scaffold_1	677805	727805
Aspergillus_fumigatus_DMC2_AF100-9B	20	16	4	0	scaffold_4	2465213	2515213
Aspergillus_fumigatus_DMC2_AF100-9B	19	16	3	0	scaffold_2	4075617	4125617
Aspergillus_fumigatus_DMC2_AF100-9B	23	21	2	0	scaffold_2	1962944	2012944
Aspergillus_fumigatus_DMC2_AF100-9B	17	13	4	0	scaffold_7	107193	157193
Aspergillus_fumigatus_DMC2_AF100-9B	14	13	1	0	scaffold_4	351128	401128
Aspergillus_fumigatus_DMC2_AF100-9B	18	17	1	0	scaffold_2	3443980	3493980
Aspergillus_fumigatus_DMC2_AF100-9B	18	17	1	0	scaffold_7	1677856	1727856
Aspergillus_fumigatus_DMC2_AF100-9B	23	20	3	0	scaffold_2	1335405	1385405
Aspergillus_fumigatus_DMC2_AF100-9B	22	19	3	0	scaffold_1	2241417	2291417
Aspergillus_fumigatus_DMC2_AF100-9B	18	17	1	0	scaffold_1	2300059	2350059
Aspergillus_fumigatus_DMC2_AF100-9B	18	14	4	0	scaffold_7	1935790	1985790
Aspergillus_fumigatus_DMC2_AF100-9B	22	19	3	0	scaffold_7	1788710	1838710
Aspergillus_fumigatus_DMC2_AF100-9B	21	21	0	0	scaffold_2	3274397	3324397
Aspergillus_fumigatus_DMC2_AF100-9B	22	17	5	0	scaffold_2	4083010	4133010
Aspergillus_fumigatus_DMC2_AF100-9B	20	19	1	0	scaffold_3	350991	400991
Aspergillus_fumigatus_DMC2_AF100-9B	25	24	1	0	scaffold_5	697251	747251
Aspergillus_fumigatus_DMC2_AF100-9B	25	22	3	0	scaffold_3	2788026	2838026
Aspergillus_fumigatus_DMC2_AF100-9B	21	19	2	0	scaffold_4	1220406	1270406
Aspergillus_fumigatus_DMC2_AF100-9B	17	15	2	0	scaffold_1	890978	940978
Aspergillus_fumigatus_DMC2_AF100-9B	19	19	0	0	scaffold_1	2192791	2242791
Aspergillus_fumigatus_DMC2_AF100-9B	23	21	2	0	scaffold_2	372072	422072
Aspergillus_fumigatus_DMC2_AF100-9B	10	9	1	0	scaffold_3	3828614	3878614
Aspergillus_fumigatus_DMC2_AF100-9B	18	15	3	0	scaffold_1	4657037	4707037
Aspergillus_fumigatus_DMC2_AF100-9B	22	20	2	0	scaffold_4	778261	828261
Aspergillus_fumigatus_DMC2_AF100-9B	23	21	2	0	scaffold_4	3538064	3588064
Aspergillus_fumigatus_DMC2_AF100-9B	16	13	3	0	scaffold_3	113920	163920
Aspergillus_fumigatus_DMC2_AF100-9B	20	18	2	0	scaffold_5	247585	297585
Aspergillus_fumigatus_DMC2_AF100-9B	16	16	0	0	scaffold_3	2270977	2320977
Aspergillus_fumigatus_DMC2_AF100-9B	29	22	7	0	scaffold_1	4153215	4203215
Aspergillus_fumigatus_DMC2_AF100-9B	17	17	0	0	scaffold_6	2569095	2619095
Aspergillus_fumigatus_DMC2_AF100-9B	18	16	2	0	scaffold_1	199526	249526
Aspergillus_fumigatus_DMC2_AF100-9B	14	14	0	0	scaffold_6	1324492	1374492
Aspergillus_fumigatus_DMC2_AF100-9B	18	17	1	0	scaffold_8	1763858	1813858
Aspergillus_fumigatus_DMC2_AF100-9B	24	22	2	0	scaffold_5	52039	102039
Aspergillus_fumigatus_DMC2_AF100-9B	18	17	1	0	scaffold_2	2891794	2941794
Aspergillus_fumigatus_DMC2_AF100-9B	21	21	0	0	scaffold_1	653932	703932
Aspergillus_fumigatus_DMC2_AF100-9B	19	13	6	0	scaffold_2	46481	96481
Aspergillus_fumigatus_DMC2_AF100-9B	8	7	1	0	scaffold_5	340049	390049
Aspergillus_fumigatus_DMC2_AF100-9B	18	17	1	0	scaffold_7	539759	589759
Aspergillus_fumigatus_DMC2_AF100-9B	18	18	0	0	scaffold_1	696750	746750
Aspergillus_fumigatus_DMC2_AF100-9B	22	19	3	0	scaffold_6	416579	466579
Aspergillus_fumigatus_DMC2_AF100-9B	18	16	2	0	scaffold_1	3532584	3582584
Aspergillus_fumigatus_DMC2_AF100-9B	8	8	0	0	scaffold_4	2237909	2287909
Aspergillus_fumigatus_DMC2_AF100-9B	22	20	2	0	scaffold_2	370818	420818
Aspergillus_fumigatus_DMC2_AF100-9B	21	19	2	0	scaffold_3	2329557	2379557
Aspergillus_fumigatus_DMC2_AF100-9B	14	13	1	0	scaffold_3	1872555	1922555
Aspergillus_fumigatus_DMC2_AF100-9B	16	16	0	0	scaffold_6	1038613	1088613
Aspergillus_fumigatus_DMC2_AF100-9B	23	21	2	0	scaffold_3	2115192	2165192
Aspergillus_fumigatus_DMC2_AF100-9B	17	16	1	0	scaffold_2	2418644	2468644
Aspergillus_fumigatus_DMC2_AF100-9B	23	18	5	0	scaffold_1	4171251	4221251
Aspergillus_fumigatus_DMC2_AF100-9B	13	13	0	0	scaffold_1	2503301	2553301
Aspergillus_fumigatus_DMC2_AF100-9B	17	17	0	0	scaffold_2	4305501	4355501
Aspergillus_fumigatus_DMC2_AF100-9B	12	12	0	0	scaffold_5	2738789	2788789
Aspergillus_fumigatus_DMC2_AF100-9B	21	15	6	0	scaffold_7	216924	266924
Aspergillus_fumigatus_DMC2_AF100-9B	12	10	2	0	scaffold_4	333974	383974
Aspergillus_fumigatus_DMC2_AF100-9B	24	22	2	0	scaffold_4	985313	1035313
Aspergillus_fumigatus_DMC2_AF100-9B	13	13	0	0	scaffold_4	2965308	3015308
Aspergillus_fumigatus_DMC2_AF100-9B	20	20	0	0	scaffold_5	1505213	1555213
Aspergillus_fumigatus_DMC2_AF100-9B	18	15	3	0	scaffold_5	578464	628464
Aspergillus_fumigatus_DMC2_AF100-9B	23	22	1	0	scaffold_5	1613666	1663666
Aspergillus_fumigatus_DMC2_AF100-9B	23	21	2	0	scaffold_4	2598526	2648526
Aspergillus_fumigatus_DMC2_AF100-9B	17	14	3	0	scaffold_1	4654089	4704089
Aspergillus_fumigatus_DMC2_AF100-9B	17	12	5	0	scaffold_1	3548950	3598950
Aspergillus_fumigatus_DMC2_AF100-9B	18	14	4	0	scaffold_7	111774	161774
Aspergillus_fumigatus_DMC2_AF100-9B	0	0	0	0	scaffold_5	1148015	1198015
Aspergillus_fumigatus_DMC2_AF100-9B	19	15	4	0	scaffold_7	361803	411803
Aspergillus_fumigatus_DMC2_AF100-9B	18	16	2	0	scaffold_6	2341749	2391749
Aspergillus_fumigatus_DMC2_AF100-9B	15	13	2	0	scaffold_1	1953406	2003406
Aspergillus_fumigatus_DMC2_AF100-9B	18	17	1	0	scaffold_3	3257805	3307805
Aspergillus_fumigatus_DMC2_AF100-9B	29	24	5	0	scaffold_3	593659	643659
Aspergillus_fumigatus_DMC2_AF100-9B	22	19	3	0	scaffold_2	1860752	1910752
Aspergillus_fumigatus_DMC2_AF100-9B	12	0	12	0	scaffold_3	68362	118362
Aspergillus_fumigatus_DMC2_AF100-9B	17	16	1	0	scaffold_2	3662241	3712241
Aspergillus_fumigatus_DMC2_AF100-9B	15	14	1	0	scaffold_4	1507807	1557807
Aspergillus_fumigatus_DMC2_AF100-9B	21	18	3	0	scaffold_3	2755625	2805625
Aspergillus_fumigatus_DMC2_AF100-9B	17	15	2	0	scaffold_6	1498363	1548363
Aspergillus_fumigatus_DMC2_AF100-9B	24	21	3	0	scaffold_6	3246863	3296863
Aspergillus_fumigatus_DMC2_AF100-9B	25	24	1	0	scaffold_5	697734	747734
Aspergillus_fumigatus_DMC2_AF100-9B	20	17	3	0	scaffold_1	3524485	3574485
Aspergillus_fumigatus_DMC2_AF100-9B	13	13	0	0	scaffold_6	1336660	1386660
Aspergillus_fumigatus_DMC2_AF100-9B	4	4	0	0	scaffold_1	1740401	1790401
Aspergillus_fumigatus_DMC2_AF100-9B	24	20	4	0	scaffold_1	137123	187123
Aspergillus_fumigatus_DMC2_AF100-9B	21	19	2	0	scaffold_4	760147	810147
Aspergillus_fumigatus_DMC2_AF100-9B	20	20	0	0	scaffold_3	2657228	2707228
Aspergillus_fumigatus_DMC2_AF100-9B	15	14	1	0	scaffold_3	840009	890009
Aspergillus_fumigatus_DMC2_AF100-9B	20	18	2	0	scaffold_3	2585947	2635947
Aspergillus_fumigatus_DMC2_AF100-9B	14	14	0	0	scaffold_6	1305777	1355777
Aspergillus_fumigatus_DMC2_AF100-9B	13	12	1	0	scaffold_3	541434	591434
Aspergillus_fumigatus_DMC2_AF100-9B	22	21	1	0	scaffold_3	2795650	2845650
Aspergillus_fumigatus_DMC2_AF100-9B	19	18	1	0	scaffold_2	2970244	3020244
Aspergillus_fumigatus_DMC2_AF100-9B	20	17	3	0	scaffold_3	4213143	4263143
Aspergillus_fumigatus_DMC2_AF100-9B	17	16	1	0	scaffold_6	3056161	3106161
Aspergillus_fumigatus_DMC2_AF100-9B	24	20	4	0	scaffold_2	2167704	2217704
Aspergillus_fumigatus_DMC2_AF100-9B	25	21	4	0	scaffold_3	165904	215904
Aspergillus_fumigatus_DMC2_AF100-9B	16	16	0	0	scaffold_3	3735228	3785228
Aspergillus_fumigatus_DMC2_AF100-9B	0	0	0	0	scaffold_2	1765244	1815244
Aspergillus_fumigatus_DMC2_AF100-9B	5	4	1	0	scaffold_4	257659	307659
Aspergillus_fumigatus_DMC2_AF100-9B	21	20	1	0	scaffold_1	551213	601213
Aspergillus_fumigatus_DMC2_AF100-9B	19	18	1	0	scaffold_4	385880	435880
Aspergillus_fumigatus_DMC2_AF100-9B	14	13	1	0	scaffold_5	1369040	1419040
Aspergillus_fumigatus_DMC2_AF100-9B	18	16	2	0	scaffold_7	1013712	1063712
Aspergillus_fumigatus_DMC2_AF100-9B	24	22	2	0	scaffold_5	737293	787293
Aspergillus_fumigatus_DMC2_AF100-9B	20	20	0	0	scaffold_6	1937243	1987243
Aspergillus_fumigatus_DMC2_AF100-9B	18	18	0	0	scaffold_5	1512756	1562756
Aspergillus_fumigatus_DMC2_AF100-9B	15	15	0	0	scaffold_5	2625452	2675452
Aspergillus_fumigatus_DMC2_AF100-9B	19	17	2	0	scaffold_3	3920041	3970041
Aspergillus_fumigatus_DMC2_AF100-9B	20	20	0	0	scaffold_5	995724	1045724
Aspergillus_fumigatus_DMC2_AF100-9B	16	14	2	0	scaffold_7	1599416	1649416
Aspergillus_fumigatus_DMC2_AF100-9B	6	5	1	0	scaffold_2	1802361	1852361
Aspergillus_fumigatus_DMC2_AF100-9B	24	23	1	0	scaffold_5	967531	1017531
Aspergillus_fumigatus_DMC2_AF100-9B	18	15	3	0	scaffold_2	1422875	1472875
Aspergillus_fumigatus_DMC2_AF100-9B	14	13	1	0	scaffold_4	1039223	1089223
Aspergillus_fumigatus_DMC2_AF100-9B	21	19	2	0	scaffold_3	2577175	2627175
Aspergillus_fumigatus_DMC2_AF100-9B	23	20	3	0	scaffold_2	4261697	4311697
Aspergillus_fumigatus_DMC2_AF100-9B	21	20	1	0	scaffold_3	2145175	2195175
Aspergillus_fumigatus_DMC2_AF100-9B	24	24	0	0	scaffold_1	3849606	3899606
Aspergillus_fumigatus_DMC2_AF100-9B	21	17	4	0	scaffold_2	485664	535664
Aspergillus_fumigatus_DMC2_AF100-9B	13	11	2	0	scaffold_8	952890	1002890
Aspergillus_fumigatus_DMC2_AF100-9B	17	15	2	0	scaffold_7	1451656	1501656
Aspergillus_fumigatus_DMC2_AF100-9B	21	19	2	0	scaffold_3	2940875	2990875
Aspergillus_fumigatus_DMC2_AF100-9B	24	22	2	0	scaffold_3	245907	295907
Aspergillus_fumigatus_DMC2_AF100-9B	21	20	1	0	scaffold_4	3156448	3206448
Aspergillus_fumigatus_DMC2_AF100-9B	19	19	0	0	scaffold_2	941777	991777
Aspergillus_fumigatus_DMC2_AF100-9B	21	18	3	0	scaffold_1	2245725	2295725
Aspergillus_fumigatus_DMC2_AF100-9B	19	18	1	0	scaffold_2	2338732	2388732
Aspergillus_fumigatus_DMC2_AF100-9B	9	6	3	0	scaffold_1	2017209	2067209
Aspergillus_fumigatus_DMC2_AF100-9B	15	15	0	0	scaffold_5	2970872	3020872
Aspergillus_fumigatus_DMC2_AF100-9B	16	15	0	1	scaffold_3	4118128	4168128
Aspergillus_fumigatus_DMC2_AF100-9B	18	17	1	0	scaffold_7	536811	586811
Aspergillus_fumigatus_DMC2_AF100-9B	8	2	6	0	scaffold_3	1473002	1523002
Aspergillus_fumigatus_DMC2_AF100-9B	17	16	1	0	scaffold_1	3652754	3702754
Aspergillus_fumigatus_DMC2_AF100-9B	15	13	2	0	scaffold_2	3484949	3534949
Aspergillus_fumigatus_DMC2_AF100-9B	21	19	2	0	scaffold_6	837988	887988
Aspergillus_fumigatus_DMC2_AF100-9B	18	17	1	0	scaffold_4	1485261	1535261
Aspergillus_fumigatus_DMC2_AF100-9B	18	17	1	0	scaffold_7	1582846	1632846
Aspergillus_fumigatus_DMC2_AF100-9B	18	16	2	0	scaffold_2	415069	465069
Aspergillus_fumigatus_DMC2_AF100-9B	22	18	4	0	scaffold_1	15566	65566
Aspergillus_fumigatus_DMC2_AF100-9B	18	17	1	0	scaffold_2	2795550	2845550
Aspergillus_fumigatus_DMC2_AF100-9B	20	20	0	0	scaffold_4	3147604	3197604
Aspergillus_fumigatus_DMC2_AF100-9B	20	16	4	0	scaffold_7	424857	474857
Aspergillus_fumigatus_DMC2_AF100-9B	19	18	1	0	scaffold_3	2017697	2067697
Aspergillus_fumigatus_DMC2_AF100-9B	22	19	3	0	scaffold_1	4020462	4070462
Aspergillus_fumigatus_DMC2_AF100-9B	22	20	2	0	scaffold_4	993534	1043534
Aspergillus_fumigatus_DMC2_AF100-9B	18	15	3	0	scaffold_4	2663296	2713296
Aspergillus_fumigatus_DMC2_AF100-9B	25	24	1	0	scaffold_2	4143741	4193741
Aspergillus_fumigatus_DMC2_AF100-9B	16	15	1	0	scaffold_5	2539807	2589807
Aspergillus_fumigatus_DMC2_AF100-9B	17	17	0	0	scaffold_6	1065427	1115427
Aspergillus_fumigatus_DMC2_AF100-9B	32	27	5	0	scaffold_2	111751	161751
Aspergillus_fumigatus_DMC2_AF100-9B	18	17	1	0	scaffold_2	2425348	2475348
Aspergillus_fumigatus_DMC2_AF100-9B	0	0	0	0	scaffold_2	1780867	1830867
Aspergillus_fumigatus_DMC2_AF100-9B	9	7	2	0	scaffold_1	2047799	2097799
Aspergillus_fumigatus_DMC2_AF100-9B	16	15	1	0	scaffold_6	2590113	2640113
Aspergillus_fumigatus_DMC2_AF100-9B	20	14	6	0	scaffold_2	47080	97080
Aspergillus_fumigatus_DMC2_AF100-9B	14	14	0	0	scaffold_3	3503133	3553133
Aspergillus_fumigatus_DMC2_AF100-9B	25	21	4	0	scaffold_1	3905318	3955318
Aspergillus_fumigatus_DMC2_AF100-9B	20	18	2	0	scaffold_4	2702529	2752529
Aspergillus_fumigatus_DMC2_AF100-9B	21	15	6	0	scaffold_7	221590	271590
Aspergillus_fumigatus_DMC2_AF100-9B	17	14	3	0	scaffold_1	4641796	4691796
Aspergillus_fumigatus_DMC2_AF100-9B	16	16	0	0	scaffold_5	3288620	3338620
Aspergillus_fumigatus_DMC2_AF100-9B	14	13	1	0	scaffold_4	1845520	1895520
Aspergillus_fumigatus_DMC2_AF100-9B	19	18	1	0	scaffold_2	1379115	1429115
Aspergillus_fumigatus_DMC2_AF100-9B	15	10	5	0	scaffold_1	3573285	3623285
Aspergillus_fumigatus_DMC2_AF100-9B	24	23	1	0	scaffold_5	3561887	3611887
Aspergillus_fumigatus_DMC2_AF100-9B	18	9	9	0	scaffold_4	28904	78904
Aspergillus_fumigatus_DMC2_AF100-9B	17	14	3	0	scaffold_3	484388	534388
Aspergillus_fumigatus_DMC2_AF100-9B	16	14	2	0	scaffold_7	382067	432067
Aspergillus_fumigatus_DMC2_AF100-9B	23	22	1	0	scaffold_1	4821288	4871288
Aspergillus_fumigatus_DMC2_AF100-9B	23	21	2	0	scaffold_7	1186707	1236707
Aspergillus_fumigatus_DMC2_AF100-9B	24	22	2	0	scaffold_2	2608674	2658674
Aspergillus_fumigatus_DMC2_AF100-9B	20	20	0	0	scaffold_6	2030493	2080493
Aspergillus_fumigatus_DMC2_AF100-9B	20	20	0	0	scaffold_4	3108831	3158831
Aspergillus_fumigatus_DMC2_AF100-9B	17	16	1	0	scaffold_3	3311663	3361663
Aspergillus_fumigatus_DMC2_AF100-9B	3	3	0	0	scaffold_3	3812398	3862398
Aspergillus_fumigatus_DMC2_AF100-9B	15	15	0	0	scaffold_6	633105	683105
Aspergillus_fumigatus_DMC2_AF100-9B	21	20	1	0	scaffold_8	32175	82175
Aspergillus_fumigatus_DMC2_AF100-9B	13	13	0	0	scaffold_2	2715092	2765092
Aspergillus_fumigatus_DMC2_AF100-9B	17	17	0	0	scaffold_3	1982972	2032972
Aspergillus_fumigatus_DMC2_AF100-9B	20	16	4	0	scaffold_7	442909	492909
Aspergillus_fumigatus_DMC2_AF100-9B	20	20	0	0	scaffold_6	494045	544045
Aspergillus_fumigatus_DMC2_AF100-9B	23	23	0	0	scaffold_4	598995	648995
Aspergillus_fumigatus_DMC2_AF100-9B	20	17	3	0	scaffold_3	877938	927938
Aspergillus_fumigatus_DMC2_AF100-9B	20	19	1	0	scaffold_1	2145151	2195151
Aspergillus_fumigatus_DMC2_AF100-9B	17	15	2	0	scaffold_4	1758890	1808890
Aspergillus_fumigatus_DMC2_AF100-9B	25	24	1	0	scaffold_2	3943821	3993821
Aspergillus_fumigatus_DMC2_AF100-9B	13	13	0	0	scaffold_2	4195105	4245105
Aspergillus_fumigatus_DMC2_AF100-9B	24	18	6	0	scaffold_8	450068	500068
Aspergillus_fumigatus_DMC2_AF100-9B	22	20	2	0	scaffold_3	4178984	4228984
Aspergillus_fumigatus_DMC2_AF100-9B	21	21	0	0	scaffold_4	3100625	3150625
Aspergillus_fumigatus_DMC2_AF100-9B	23	19	4	0	scaffold_1	101082	151082
Aspergillus_fumigatus_DMC2_AF100-9B	17	16	1	0	scaffold_1	3773467	3823467
Aspergillus_fumigatus_DMC2_AF100-9B	15	13	2	0	scaffold_2	1314017	1364017
Aspergillus_fumigatus_DMC2_AF100-9B	19	17	2	0	scaffold_2	2906227	2956227
Aspergillus_fumigatus_DMC2_AF100-9B	16	13	3	0	scaffold_5	1421222	1471222
Aspergillus_fumigatus_DMC2_AF100-9B	22	20	2	0	scaffold_4	805906	855906
Aspergillus_fumigatus_DMC2_AF100-9B	7	7	0	0	scaffold_3	1688104	1738104
Aspergillus_fumigatus_DMC2_AF100-9B	22	21	1	0	scaffold_5	1839497	1889497
Aspergillus_fumigatus_DMC2_AF100-9B	20	15	5	0	scaffold_1	4263912	4313912
Aspergillus_fumigatus_DMC2_AF100-9B	15	14	1	0	scaffold_4	1511166	1561166
Aspergillus_fumigatus_DMC2_AF100-9B	18	18	0	0	scaffold_4	1671038	1721038
Aspergillus_fumigatus_DMC2_AF100-9B	20	17	3	0	scaffold_5	3401337	3451337
Aspergillus_fumigatus_DMC2_AF100-9B	19	19	0	0	scaffold_3	2490763	2540763
Aspergillus_fumigatus_DMC2_AF100-9B	18	18	0	0	scaffold_1	947740	997740
Aspergillus_fumigatus_DMC2_AF100-9B	24	23	1	0	scaffold_3	648090	698090
Aspergillus_fumigatus_DMC2_AF100-9B	21	20	1	0	scaffold_7	924000	974000
Aspergillus_fumigatus_DMC2_AF100-9B	19	17	2	0	scaffold_2	2904782	2954782
Aspergillus_fumigatus_DMC2_AF100-9B	20	19	1	0	scaffold_5	939936	989936
Aspergillus_fumigatus_DMC2_AF100-9B	23	22	1	0	scaffold_6	938184	988184
Aspergillus_fumigatus_DMC2_AF100-9B	16	13	3	0	scaffold_1	1567473	1617473
Aspergillus_fumigatus_DMC2_AF100-9B	15	14	1	0	scaffold_3	2209284	2259284
Aspergillus_fumigatus_DMC2_AF100-9B	16	13	3	0	scaffold_3	3173772	3223772
Aspergillus_fumigatus_DMC2_AF100-9B	13	11	2	0	scaffold_3	1542034	1592034
Aspergillus_fumigatus_DMC2_AF100-9B	15	15	0	0	scaffold_5	2575526	2625526
Aspergillus_fumigatus_DMC2_AF100-9B	16	16	0	0	scaffold_1	2209881	2259881
Aspergillus_fumigatus_DMC2_AF100-9B	18	17	1	0	scaffold_5	3106939	3156939
Aspergillus_fumigatus_DMC2_AF100-9B	17	14	3	0	scaffold_8	405604	455604
Aspergillus_fumigatus_DMC2_AF100-9B	18	17	1	0	scaffold_3	1210767	1260767
Aspergillus_fumigatus_DMC2_AF100-9B	20	18	2	0	scaffold_4	963727	1013727
Aspergillus_fumigatus_DMC2_AF100-9B	11	11	0	0	scaffold_2	2233721	2283721
Aspergillus_fumigatus_DMC2_AF100-9B	16	16	0	0	scaffold_4	3628956	3678956
Aspergillus_fumigatus_DMC2_AF100-9B	26	22	4	0	scaffold_3	923282	973282
Aspergillus_fumigatus_DMC2_AF100-9B	17	14	3	0	scaffold_1	3688331	3738331
Aspergillus_fumigatus_DMC2_AF100-9B	16	16	0	0	scaffold_6	1399040	1449040
Aspergillus_fumigatus_DMC2_AF100-9B	15	14	1	0	scaffold_3	546184	596184
Aspergillus_fumigatus_DMC2_AF100-9B	13	12	1	0	scaffold_4	349974	399974
Aspergillus_fumigatus_DMC2_AF100-9B	16	16	0	0	scaffold_1	933553	983553
Aspergillus_fumigatus_DMC2_AF100-9B	24	18	6	0	scaffold_6	191394	241394
Aspergillus_fumigatus_DMC2_AF100-9B	20	18	2	0	scaffold_6	1526454	1576454
Aspergillus_fumigatus_DMC2_AF100-9B	15	12	3	0	scaffold_2	1289121	1339121
Aspergillus_fumigatus_DMC2_AF100-9B	20	18	2	0	scaffold_6	1796090	1846090
Aspergillus_fumigatus_DMC2_AF100-9B	16	15	1	0	scaffold_3	2210431	2260431
Aspergillus_fumigatus_DMC2_AF100-9B	19	19	0	0	scaffold_7	1524385	1574385
Aspergillus_fumigatus_DMC2_AF100-9B	25	22	3	0	scaffold_3	2839732	2889732
Aspergillus_fumigatus_DMC2_AF100-9B	16	15	1	0	scaffold_4	1650763	1700763
Aspergillus_fumigatus_DMC2_AF100-9B	13	11	2	0	scaffold_1	1552905	1602905
Aspergillus_fumigatus_DMC2_AF100-9B	9	8	1	0	scaffold_1	1765429	1815429
Aspergillus_fumigatus_DMC2_AF100-9B	21	18	3	0	scaffold_8	18329	68329
Aspergillus_fumigatus_DMC2_AF100-9B	17	17	0	0	scaffold_4	2743507	2793507
Aspergillus_fumigatus_DMC2_AF100-9B	20	19	1	0	scaffold_2	2927523	2977523
Aspergillus_fumigatus_DMC2_AF100-9B	10	8	2	0	scaffold_4	2280482	2330482
Aspergillus_fumigatus_DMC2_AF100-9B	18	16	2	0	scaffold_7	1466583	1516583
Aspergillus_fumigatus_DMC2_AF100-9B	19	16	3	0	scaffold_6	1698567	1748567
Aspergillus_fumigatus_DMC2_AF100-9B	15	13	2	0	scaffold_7	406160	456160
Aspergillus_fumigatus_DMC2_AF100-9B	29	24	5	0	scaffold_3	597994	647994
Aspergillus_fumigatus_DMC2_AF100-9B	17	15	2	0	scaffold_4	2503204	2553204
Aspergillus_fumigatus_DMC2_AF100-9B	19	16	3	0	scaffold_7	457401	507401
Aspergillus_fumigatus_DMC2_AF100-9B	16	14	2	0	scaffold_4	706185	756185
Aspergillus_fumigatus_DMC2_AF100-9B	22	19	3	0	scaffold_5	79091	129091
Aspergillus_fumigatus_DMC2_AF100-9B	12	11	1	0	scaffold_1	2861809	2911809
Aspergillus_fumigatus_DMC2_AF100-9B	23	22	1	0	scaffold_2	3927282	3977282
Aspergillus_fumigatus_DMC2_AF100-9B	16	14	2	0	scaffold_3	2896985	2946985
Aspergillus_fumigatus_DMC2_AF100-9B	18	16	2	0	scaffold_2	1322753	1372753
Aspergillus_fumigatus_DMC2_AF100-9B	20	19	1	0	scaffold_7	1266772	1316772
Aspergillus_fumigatus_DMC2_AF100-9B	22	21	1	0	scaffold_1	316295	366295
Aspergillus_fumigatus_DMC2_AF100-9B	20	18	2	0	scaffold_1	2536449	2586449
Aspergillus_fumigatus_DMC2_AF100-9B	16	15	1	0	scaffold_2	3625345	3675345
Aspergillus_fumigatus_DMC2_AF100-9B	18	18	0	0	scaffold_1	1315131	1365131
Aspergillus_fumigatus_DMC2_AF100-9B	22	21	1	0	scaffold_8	1699258	1749258
Aspergillus_fumigatus_DMC2_AF100-9B	15	14	1	0	scaffold_2	3512890	3562890
Aspergillus_fumigatus_DMC2_AF100-9B	26	22	4	0	scaffold_7	264961	314961
Aspergillus_fumigatus_DMC2_AF100-9B	19	17	2	0	scaffold_1	376294	426294
Aspergillus_fumigatus_DMC2_AF100-9B	17	17	0	0	scaffold_2	2299668	2349668
Aspergillus_fumigatus_DMC2_AF100-9B	19	19	0	0	scaffold_5	3013349	3063349
Aspergillus_fumigatus_DMC2_AF100-9B	20	19	1	0	scaffold_4	1116170	1166170
Aspergillus_fumigatus_DMC2_AF100-9B	19	18	1	0	scaffold_3	3488398	3538398
Aspergillus_fumigatus_DMC2_AF100-9B	21	19	2	0	scaffold_3	2738399	2788399
Aspergillus_fumigatus_DMC2_AF100-9B	9	7	2	0	scaffold_2	752375	802375
Aspergillus_fumigatus_DMC2_AF100-9B	16	15	1	0	scaffold_4	2326792	2376792
Aspergillus_fumigatus_DMC2_AF100-9B	22	21	1	0	scaffold_4	3478401	3528401
Aspergillus_fumigatus_DMC2_AF100-9B	18	16	2	0	scaffold_3	119204	169204
Aspergillus_fumigatus_DMC2_AF100-9B	16	16	0	0	scaffold_6	1863495	1913495
Aspergillus_fumigatus_DMC2_AF100-9B	21	18	3	0	scaffold_5	2214959	2264959
Aspergillus_fumigatus_DMC2_AF100-9B	19	15	4	0	scaffold_1	4198254	4248254
Aspergillus_fumigatus_DMC2_AF100-9B	22	20	2	0	scaffold_6	1228578	1278578
Aspergillus_fumigatus_DMC2_AF100-9B	23	18	5	0	scaffold_3	2561703	2611703
Aspergillus_fumigatus_DMC2_AF100-9B	14	14	0	0	scaffold_5	2070345	2120345
Aspergillus_fumigatus_DMC2_AF100-9B	9	7	2	0	scaffold_7	740438	790438
Aspergillus_fumigatus_DMC2_AF100-9B	23	21	2	0	scaffold_5	737522	787522
Aspergillus_fumigatus_DMC2_AF100-9B	22	20	2	0	scaffold_2	1061841	1111841
Aspergillus_fumigatus_DMC2_AF100-9B	7	5	2	0	scaffold_2	745984	795984
Aspergillus_fumigatus_DMC2_AF100-9B	18	17	1	0	scaffold_6	1675014	1725014
Aspergillus_fumigatus_DMC2_AF100-9B	20	19	1	0	scaffold_7	530328	580328
Aspergillus_fumigatus_DMC2_AF100-9B	24	21	3	0	scaffold_8	1431857	1481857
Aspergillus_fumigatus_DMC2_AF100-9B	24	22	2	0	scaffold_4	2025945	2075945
Aspergillus_fumigatus_DMC2_AF100-9B	21	20	1	0	scaffold_6	1515059	1565059
Aspergillus_fumigatus_DMC2_AF100-9B	16	16	0	0	scaffold_5	2677028	2727028
Aspergillus_fumigatus_DMC2_AF100-9B	26	20	6	0	scaffold_8	1471016	1521016
Aspergillus_fumigatus_DMC2_AF100-9B	17	15	2	0	scaffold_1	382516	432516
Aspergillus_fumigatus_DMC2_AF100-9B	18	16	2	0	scaffold_7	1031813	1081813
Aspergillus_fumigatus_DMC2_AF100-9B	26	24	2	0	scaffold_3	262494	312494
Aspergillus_fumigatus_DMC2_AF100-9B	18	16	2	0	scaffold_2	2543485	2593485
Aspergillus_fumigatus_DMC2_AF100-9B	17	14	3	0	scaffold_1	4655378	4705378
Aspergillus_fumigatus_DMC2_AF100-9B	16	15	1	0	scaffold_2	4164076	4214076
Aspergillus_fumigatus_DMC2_AF100-9B	21	20	1	0	scaffold_5	1853229	1903229
Aspergillus_fumigatus_DMC2_AF100-9B	19	1	18	0	scaffold_3	1123116	1173116
Aspergillus_fumigatus_DMC2_AF100-9B	17	17	0	0	scaffold_1	955431	1005431
Aspergillus_fumigatus_DMC2_AF100-9B	17	17	0	0	scaffold_1	501210	551210
Aspergillus_fumigatus_DMC2_AF100-9B	3	1	2	0	scaffold_2	4366952	4416952
Aspergillus_fumigatus_DMC2_AF100-9B	17	9	8	0	scaffold_1	4552757	4602757
Aspergillus_fumigatus_DMC2_AF100-9B	18	17	1	0	scaffold_6	1507431	1557431
Aspergillus_fumigatus_DMC2_AF100-9B	19	18	1	0	scaffold_4	384782	434782
Aspergillus_fumigatus_DMC2_AF100-9B	2	1	1	0	scaffold_3	1506384	1556384
Aspergillus_fumigatus_DMC2_AF100-9B	14	13	1	0	scaffold_3	1873012	1923012
Aspergillus_fumigatus_DMC2_AF100-9B	13	12	1	0	scaffold_1	2845162	2895162
Aspergillus_fumigatus_DMC2_AF100-9B	18	17	1	0	scaffold_1	4030914	4080914
Aspergillus_fumigatus_DMC2_AF100-9B	16	15	1	0	scaffold_5	865654	915654
Aspergillus_fumigatus_DMC2_AF100-9B	12	12	0	0	scaffold_1	3134008	3184008
Aspergillus_fumigatus_DMC2_AF100-9B	0	0	0	0	scaffold_5	1131530	1181530
Aspergillus_fumigatus_DMC2_AF100-9B	19	17	2	0	scaffold_1	3736235	3786235
Aspergillus_fumigatus_DMC2_AF100-9B	11	10	1	0	scaffold_8	583040	633040
Aspergillus_fumigatus_DMC2_AF100-9B	29	24	5	0	scaffold_3	3137992	3187992
Aspergillus_fumigatus_DMC2_AF100-9B	29	25	4	0	scaffold_2	123154	173154
Aspergillus_fumigatus_DMC2_AF100-9B	22	13	9	0	scaffold_5	2141487	2191487
Aspergillus_fumigatus_DMC2_AF100-9B	21	19	2	0	scaffold_4	2093590	2143590
Aspergillus_fumigatus_DMC2_AF100-9B	19	17	2	0	scaffold_3	791530	841530
Aspergillus_fumigatus_DMC2_AF100-9B	18	18	0	0	scaffold_2	2963228	3013228
Aspergillus_fumigatus_DMC2_AF100-9B	21	19	2	0	scaffold_5	238314	288314
Aspergillus_fumigatus_DMC2_AF100-9B	17	15	2	0	scaffold_5	878945	928945
Aspergillus_fumigatus_DMC2_AF100-9B	22	22	0	0	scaffold_4	600245	650245
Aspergillus_fumigatus_DMC2_AF100-9B	18	17	1	0	scaffold_2	3821243	3871243
Aspergillus_fumigatus_DMC2_AF100-9B	19	18	1	0	scaffold_5	2450056	2500056
Aspergillus_fumigatus_DMC2_AF100-9B	16	16	0	0	scaffold_3	2240396	2290396
Aspergillus_fumigatus_DMC2_AF100-9B	18	16	2	0	scaffold_4	2296929	2346929
Aspergillus_fumigatus_DMC2_AF100-9B	25	23	2	0	scaffold_5	3359185	3409185
Aspergillus_fumigatus_DMC2_AF100-9B	18	0	18	0	scaffold_1	4333956	4383956
Aspergillus_fumigatus_DMC2_AF100-9B	20	20	0	0	scaffold_6	506627	556627
Aspergillus_fumigatus_DMC2_AF100-9B	17	17	0	0	scaffold_3	2263370	2313370
Aspergillus_fumigatus_DMC2_AF100-9B	14	12	2	0	scaffold_8	1372246	1422246
Aspergillus_fumigatus_DMC2_AF100-9B	22	21	1	0	scaffold_2	1956743	2006743
Aspergillus_fumigatus_DMC2_AF100-9B	3	3	0	0	scaffold_1	1835709	1885709
Aspergillus_fumigatus_DMC2_AF100-9B	20	20	0	0	scaffold_4	3589895	3639895
Aspergillus_fumigatus_DMC2_AF100-9B	18	16	2	0	scaffold_7	473963	523963
Aspergillus_fumigatus_DMC2_AF100-9B	3	2	1	0	scaffold_8	857703	907703
Aspergillus_fumigatus_DMC2_AF100-9B	19	18	1	0	scaffold_2	921706	971706
Aspergillus_fumigatus_DMC2_AF100-9B	14	13	1	0	scaffold_5	2425132	2475132
Aspergillus_fumigatus_DMC2_AF100-9B	17	15	2	0	scaffold_3	2189007	2239007
Aspergillus_fumigatus_DMC2_AF100-9B	22	18	4	0	scaffold_4	1929122	1979122
Aspergillus_fumigatus_DMC2_AF100-9B	13	13	0	0	scaffold_5	2052480	2102480
Aspergillus_fumigatus_DMC2_AF100-9B	17	16	1	0	scaffold_1	4670866	4720866
Aspergillus_fumigatus_DMC2_AF100-9B	19	16	3	0	scaffold_2	3068944	3118944
Aspergillus_fumigatus_DMC2_AF100-9B	21	20	1	0	scaffold_1	2331736	2381736
Aspergillus_fumigatus_DMC2_AF100-9B	22	21	1	0	scaffold_1	2159813	2209813
Aspergillus_fumigatus_DMC2_AF100-9B	20	19	1	0	scaffold_5	3045793	3095793
Aspergillus_fumigatus_DMC2_AF100-9B	21	19	2	0	scaffold_3	4166913	4216913
Aspergillus_fumigatus_DMC2_AF100-9B	18	17	1	0	scaffold_6	2564946	2614946
Aspergillus_fumigatus_DMC2_AF100-9B	21	17	4	0	scaffold_5	462508	512508
