STRAIN	TOTAL	CORE	ACCESSORY	SINGLETON	CHROM	START	END
Aspergillus_fumigatus_B6894_CDC_5	15	11	4	0	scaffold_1	3899224	3949224
Aspergillus_fumigatus_B6894_CDC_5	16	16	0	0	scaffold_5	622819	672819
Aspergillus_fumigatus_B6894_CDC_5	21	18	3	0	scaffold_2	3973482	4023482
Aspergillus_fumigatus_B6894_CDC_5	19	18	1	0	scaffold_2	2422653	2472653
Aspergillus_fumigatus_B6894_CDC_5	20	19	1	0	scaffold_7	1131526	1181526
Aspergillus_fumigatus_B6894_CDC_5	22	21	1	0	scaffold_2	499277	549277
Aspergillus_fumigatus_B6894_CDC_5	19	18	1	0	scaffold_2	2117250	2167250
Aspergillus_fumigatus_B6894_CDC_5	14	13	1	0	scaffold_4	3232320	3282320
Aspergillus_fumigatus_B6894_CDC_5	0	0	0	0	scaffold_6	1154161	1204161
Aspergillus_fumigatus_B6894_CDC_5	19	19	0	0	scaffold_7	1141791	1191791
Aspergillus_fumigatus_B6894_CDC_5	18	17	1	0	scaffold_4	2554617	2604617
Aspergillus_fumigatus_B6894_CDC_5	12	11	1	0	scaffold_1	1117288	1167288
Aspergillus_fumigatus_B6894_CDC_5	18	18	0	0	scaffold_2	221661	271661
Aspergillus_fumigatus_B6894_CDC_5	20	18	2	0	scaffold_1	1934156	1984156
Aspergillus_fumigatus_B6894_CDC_5	19	16	3	0	scaffold_5	3555720	3605720
Aspergillus_fumigatus_B6894_CDC_5	17	15	2	0	scaffold_3	3419857	3469857
Aspergillus_fumigatus_B6894_CDC_5	8	7	1	0	scaffold_3	1121230	1171230
Aspergillus_fumigatus_B6894_CDC_5	14	14	0	0	scaffold_5	737558	787558
Aspergillus_fumigatus_B6894_CDC_5	20	19	1	0	scaffold_5	1590948	1640948
Aspergillus_fumigatus_B6894_CDC_5	21	21	0	0	scaffold_2	3937788	3987788
Aspergillus_fumigatus_B6894_CDC_5	20	17	3	0	scaffold_1	2920203	2970203
Aspergillus_fumigatus_B6894_CDC_5	20	20	0	0	scaffold_4	1838993	1888993
Aspergillus_fumigatus_B6894_CDC_5	18	18	0	0	scaffold_3	680629	730629
Aspergillus_fumigatus_B6894_CDC_5	21	19	2	0	scaffold_1	4680944	4730944
Aspergillus_fumigatus_B6894_CDC_5	13	13	0	0	scaffold_2	3863778	3913778
Aspergillus_fumigatus_B6894_CDC_5	15	14	1	0	scaffold_1	2741658	2791658
Aspergillus_fumigatus_B6894_CDC_5	16	12	4	0	scaffold_4	325783	375783
Aspergillus_fumigatus_B6894_CDC_5	22	21	1	0	scaffold_5	3639839	3689839
Aspergillus_fumigatus_B6894_CDC_5	22	22	0	0	scaffold_5	1042123	1092123
Aspergillus_fumigatus_B6894_CDC_5	26	21	5	0	scaffold_3	106351	156351
Aspergillus_fumigatus_B6894_CDC_5	18	17	1	0	scaffold_2	2429207	2479207
Aspergillus_fumigatus_B6894_CDC_5	19	17	2	0	scaffold_2	865294	915294
Aspergillus_fumigatus_B6894_CDC_5	23	20	3	0	scaffold_5	3724359	3774359
Aspergillus_fumigatus_B6894_CDC_5	17	16	1	0	scaffold_6	544740	594740
Aspergillus_fumigatus_B6894_CDC_5	18	16	2	0	scaffold_7	1262187	1312187
Aspergillus_fumigatus_B6894_CDC_5	17	17	0	0	scaffold_1	591832	641832
Aspergillus_fumigatus_B6894_CDC_5	12	12	0	0	scaffold_4	2902265	2952265
Aspergillus_fumigatus_B6894_CDC_5	19	16	3	0	scaffold_3	945516	995516
Aspergillus_fumigatus_B6894_CDC_5	16	15	1	0	scaffold_5	3128970	3178970
Aspergillus_fumigatus_B6894_CDC_5	16	16	0	0	scaffold_3	3235467	3285467
Aspergillus_fumigatus_B6894_CDC_5	20	14	6	0	scaffold_3	234030	284030
Aspergillus_fumigatus_B6894_CDC_5	18	15	3	0	scaffold_6	611324	661324
Aspergillus_fumigatus_B6894_CDC_5	19	15	4	0	scaffold_1	4583666	4633666
Aspergillus_fumigatus_B6894_CDC_5	20	19	1	0	scaffold_2	920726	970726
Aspergillus_fumigatus_B6894_CDC_5	17	17	0	0	scaffold_3	1237701	1287701
Aspergillus_fumigatus_B6894_CDC_5	18	14	4	0	scaffold_3	3790388	3840388
Aspergillus_fumigatus_B6894_CDC_5	20	18	2	0	scaffold_2	1348298	1398298
Aspergillus_fumigatus_B6894_CDC_5	4	4	0	0	scaffold_4	2927616	2977616
Aspergillus_fumigatus_B6894_CDC_5	22	20	2	0	scaffold_8	353259	403259
Aspergillus_fumigatus_B6894_CDC_5	18	17	1	0	scaffold_3	1569536	1619536
Aspergillus_fumigatus_B6894_CDC_5	8	7	1	0	scaffold_5	1185606	1235606
Aspergillus_fumigatus_B6894_CDC_5	16	14	2	0	scaffold_6	1456429	1506429
Aspergillus_fumigatus_B6894_CDC_5	17	16	1	0	scaffold_4	1862350	1912350
Aspergillus_fumigatus_B6894_CDC_5	24	23	1	0	scaffold_1	4619976	4669976
Aspergillus_fumigatus_B6894_CDC_5	3	3	0	0	scaffold_2	1878762	1928762
Aspergillus_fumigatus_B6894_CDC_5	12	10	2	0	scaffold_1	1114211	1164211
Aspergillus_fumigatus_B6894_CDC_5	22	18	4	0	scaffold_6	287699	337699
Aspergillus_fumigatus_B6894_CDC_5	22	8	14	0	scaffold_3	222968	272968
Aspergillus_fumigatus_B6894_CDC_5	20	17	3	0	scaffold_3	906822	956822
Aspergillus_fumigatus_B6894_CDC_5	22	22	0	0	scaffold_6	1808419	1858419
Aspergillus_fumigatus_B6894_CDC_5	14	14	0	0	scaffold_5	724619	774619
Aspergillus_fumigatus_B6894_CDC_5	26	23	3	0	scaffold_5	3782189	3832189
Aspergillus_fumigatus_B6894_CDC_5	18	18	0	0	scaffold_3	1842990	1892990
Aspergillus_fumigatus_B6894_CDC_5	0	0	0	0	scaffold_6	1117577	1167577
Aspergillus_fumigatus_B6894_CDC_5	9	8	1	0	scaffold_4	2314177	2364177
Aspergillus_fumigatus_B6894_CDC_5	15	12	3	0	scaffold_1	2002788	2052788
Aspergillus_fumigatus_B6894_CDC_5	18	17	1	0	scaffold_3	2827168	2877168
Aspergillus_fumigatus_B6894_CDC_5	21	17	4	0	scaffold_2	397753	447753
Aspergillus_fumigatus_B6894_CDC_5	17	16	1	0	scaffold_3	3427920	3477920
Aspergillus_fumigatus_B6894_CDC_5	21	18	3	0	scaffold_7	360809	410809
Aspergillus_fumigatus_B6894_CDC_5	17	15	2	0	scaffold_6	875251	925251
Aspergillus_fumigatus_B6894_CDC_5	15	14	1	0	scaffold_5	1946527	1996527
Aspergillus_fumigatus_B6894_CDC_5	19	14	5	0	scaffold_1	4531312	4581312
Aspergillus_fumigatus_B6894_CDC_5	16	11	5	0	scaffold_4	368062	418062
Aspergillus_fumigatus_B6894_CDC_5	21	17	4	0	scaffold_1	4562568	4612568
Aspergillus_fumigatus_B6894_CDC_5	19	15	4	0	scaffold_3	126838	176838
Aspergillus_fumigatus_B6894_CDC_5	23	23	0	0	scaffold_6	1770454	1820454
Aspergillus_fumigatus_B6894_CDC_5	18	17	1	0	scaffold_3	2716139	2766139
Aspergillus_fumigatus_B6894_CDC_5	18	0	18	0	scaffold_1	4349144	4399144
Aspergillus_fumigatus_B6894_CDC_5	20	16	4	0	scaffold_3	120583	170583
Aspergillus_fumigatus_B6894_CDC_5	21	20	1	0	scaffold_2	2202318	2252318
Aspergillus_fumigatus_B6894_CDC_5	16	16	0	0	scaffold_3	1250548	1300548
Aspergillus_fumigatus_B6894_CDC_5	18	15	3	0	scaffold_8	1400943	1450943
Aspergillus_fumigatus_B6894_CDC_5	23	22	1	0	scaffold_6	2931193	2981193
Aspergillus_fumigatus_B6894_CDC_5	19	15	4	0	scaffold_5	3336832	3386832
Aspergillus_fumigatus_B6894_CDC_5	22	19	3	0	scaffold_7	1482504	1532504
Aspergillus_fumigatus_B6894_CDC_5	18	14	4	0	scaffold_8	1212981	1262981
Aspergillus_fumigatus_B6894_CDC_5	16	16	0	0	scaffold_1	506838	556838
Aspergillus_fumigatus_B6894_CDC_5	19	16	3	0	scaffold_4	870609	920609
Aspergillus_fumigatus_B6894_CDC_5	20	18	2	0	scaffold_8	627689	677689
Aspergillus_fumigatus_B6894_CDC_5	18	18	0	0	scaffold_6	3045954	3095954
Aspergillus_fumigatus_B6894_CDC_5	19	19	0	0	scaffold_5	2840346	2890346
Aspergillus_fumigatus_B6894_CDC_5	20	20	0	0	scaffold_4	3767673	3817673
Aspergillus_fumigatus_B6894_CDC_5	25	21	4	0	scaffold_1	3939147	3989147
Aspergillus_fumigatus_B6894_CDC_5	17	15	2	0	scaffold_5	1352277	1402277
Aspergillus_fumigatus_B6894_CDC_5	0	0	0	0	scaffold_6	1171020	1221020
Aspergillus_fumigatus_B6894_CDC_5	16	15	1	0	scaffold_6	2731086	2781086
Aspergillus_fumigatus_B6894_CDC_5	18	17	1	0	scaffold_5	682673	732673
Aspergillus_fumigatus_B6894_CDC_5	20	18	2	0	scaffold_2	4414824	4464824
Aspergillus_fumigatus_B6894_CDC_5	22	22	0	0	scaffold_1	450274	500274
Aspergillus_fumigatus_B6894_CDC_5	21	19	2	0	scaffold_3	4094097	4144097
Aspergillus_fumigatus_B6894_CDC_5	16	11	5	0	scaffold_2	536631	586631
Aspergillus_fumigatus_B6894_CDC_5	21	20	1	0	scaffold_4	707086	757086
Aspergillus_fumigatus_B6894_CDC_5	8	8	0	0	scaffold_1	3054957	3104957
Aspergillus_fumigatus_B6894_CDC_5	15	13	2	0	scaffold_4	410667	460667
Aspergillus_fumigatus_B6894_CDC_5	15	15	0	0	scaffold_6	2612541	2662541
Aspergillus_fumigatus_B6894_CDC_5	18	15	3	0	scaffold_8	30493	80493
Aspergillus_fumigatus_B6894_CDC_5	19	16	3	0	scaffold_4	2528779	2578779
Aspergillus_fumigatus_B6894_CDC_5	19	19	0	0	scaffold_8	1009830	1059830
Aspergillus_fumigatus_B6894_CDC_5	20	20	0	0	scaffold_4	3335432	3385432
Aspergillus_fumigatus_B6894_CDC_5	15	15	0	0	scaffold_1	2672351	2722351
Aspergillus_fumigatus_B6894_CDC_5	14	10	4	0	scaffold_7	641891	691891
Aspergillus_fumigatus_B6894_CDC_5	15	14	1	0	scaffold_2	2760562	2810562
Aspergillus_fumigatus_B6894_CDC_5	14	14	0	0	scaffold_3	2852321	2902321
Aspergillus_fumigatus_B6894_CDC_5	18	17	1	0	scaffold_5	2017291	2067291
Aspergillus_fumigatus_B6894_CDC_5	20	18	2	0	scaffold_2	1798259	1848259
Aspergillus_fumigatus_B6894_CDC_5	23	21	2	0	scaffold_8	354061	404061
Aspergillus_fumigatus_B6894_CDC_5	8	6	2	0	scaffold_3	4127140	4177140
Aspergillus_fumigatus_B6894_CDC_5	12	11	1	0	scaffold_4	1641510	1691510
Aspergillus_fumigatus_B6894_CDC_5	3	3	0	0	scaffold_4	2959382	3009382
Aspergillus_fumigatus_B6894_CDC_5	17	16	1	0	scaffold_2	2625911	2675911
Aspergillus_fumigatus_B6894_CDC_5	20	17	3	0	scaffold_4	792889	842889
Aspergillus_fumigatus_B6894_CDC_5	19	19	0	0	scaffold_4	1813899	1863899
Aspergillus_fumigatus_B6894_CDC_5	20	20	0	0	scaffold_7	1693293	1743293
Aspergillus_fumigatus_B6894_CDC_5	17	16	1	0	scaffold_7	1375715	1425715
Aspergillus_fumigatus_B6894_CDC_5	15	12	3	0	scaffold_1	1672554	1722554
Aspergillus_fumigatus_B6894_CDC_5	24	22	2	0	scaffold_6	978250	1028250
Aspergillus_fumigatus_B6894_CDC_5	20	15	5	0	scaffold_1	4527713	4577713
Aspergillus_fumigatus_B6894_CDC_5	14	14	0	0	scaffold_2	656011	706011
Aspergillus_fumigatus_B6894_CDC_5	16	13	3	0	scaffold_8	1385827	1435827
Aspergillus_fumigatus_B6894_CDC_5	18	16	2	0	scaffold_7	392280	442280
Aspergillus_fumigatus_B6894_CDC_5	20	20	0	0	scaffold_3	3883283	3933283
Aspergillus_fumigatus_B6894_CDC_5	15	15	0	0	scaffold_1	1136413	1186413
Aspergillus_fumigatus_B6894_CDC_5	17	14	3	0	scaffold_4	3069055	3119055
Aspergillus_fumigatus_B6894_CDC_5	17	15	2	0	scaffold_5	1572725	1622725
Aspergillus_fumigatus_B6894_CDC_5	19	18	1	0	scaffold_1	1624708	1674708
Aspergillus_fumigatus_B6894_CDC_5	18	18	0	0	scaffold_5	601254	651254
Aspergillus_fumigatus_B6894_CDC_5	20	18	2	0	scaffold_4	1190985	1240985
Aspergillus_fumigatus_B6894_CDC_5	9	9	0	0	scaffold_1	3058799	3108799
Aspergillus_fumigatus_B6894_CDC_5	17	13	4	0	scaffold_4	364313	414313
Aspergillus_fumigatus_B6894_CDC_5	6	6	0	0	scaffold_8	830484	880484
Aspergillus_fumigatus_B6894_CDC_5	22	21	1	0	scaffold_2	2445569	2495569
Aspergillus_fumigatus_B6894_CDC_5	27	22	5	0	scaffold_5	150028	200028
Aspergillus_fumigatus_B6894_CDC_5	20	19	1	0	scaffold_4	1562198	1612198
Aspergillus_fumigatus_B6894_CDC_5	20	20	0	0	scaffold_1	624944	674944
Aspergillus_fumigatus_B6894_CDC_5	16	0	16	0	scaffold_1	4295368	4345368
Aspergillus_fumigatus_B6894_CDC_5	18	18	0	0	scaffold_5	1141868	1191868
Aspergillus_fumigatus_B6894_CDC_5	13	12	1	0	scaffold_2	822481	872481
Aspergillus_fumigatus_B6894_CDC_5	19	17	2	0	scaffold_7	1276325	1326325
Aspergillus_fumigatus_B6894_CDC_5	21	20	1	0	scaffold_4	1243969	1293969
Aspergillus_fumigatus_B6894_CDC_5	20	1	19	0	scaffold_5	908491	958491
Aspergillus_fumigatus_B6894_CDC_5	21	20	1	0	scaffold_2	2015289	2065289
Aspergillus_fumigatus_B6894_CDC_5	25	22	3	0	scaffold_2	2092637	2142637
Aspergillus_fumigatus_B6894_CDC_5	19	17	2	0	scaffold_2	2731395	2781395
Aspergillus_fumigatus_B6894_CDC_5	18	16	2	0	scaffold_2	3269809	3319809
Aspergillus_fumigatus_B6894_CDC_5	18	18	0	0	scaffold_3	3103858	3153858
Aspergillus_fumigatus_B6894_CDC_5	19	19	0	0	scaffold_5	1850624	1900624
Aspergillus_fumigatus_B6894_CDC_5	16	15	1	0	scaffold_4	1792482	1842482
Aspergillus_fumigatus_B6894_CDC_5	23	21	2	0	scaffold_8	372748	422748
Aspergillus_fumigatus_B6894_CDC_5	20	20	0	0	scaffold_3	1214359	1264359
Aspergillus_fumigatus_B6894_CDC_5	20	18	2	0	scaffold_6	1570010	1620010
Aspergillus_fumigatus_B6894_CDC_5	17	16	0	1	scaffold_3	3482888	3532888
Aspergillus_fumigatus_B6894_CDC_5	19	17	2	0	scaffold_1	367698	417698
Aspergillus_fumigatus_B6894_CDC_5	19	19	0	0	scaffold_5	607334	657334
Aspergillus_fumigatus_B6894_CDC_5	27	18	9	0	scaffold_5	188567	238567
Aspergillus_fumigatus_B6894_CDC_5	18	17	1	0	scaffold_1	1144926	1194926
Aspergillus_fumigatus_B6894_CDC_5	20	20	0	0	scaffold_5	538925	588925
Aspergillus_fumigatus_B6894_CDC_5	20	20	0	0	scaffold_3	1877534	1927534
Aspergillus_fumigatus_B6894_CDC_5	18	17	1	0	scaffold_2	2138481	2188481
Aspergillus_fumigatus_B6894_CDC_5	18	17	1	0	scaffold_5	2085533	2135533
Aspergillus_fumigatus_B6894_CDC_5	15	14	1	0	scaffold_2	332628	382628
Aspergillus_fumigatus_B6894_CDC_5	15	13	2	0	scaffold_2	1808778	1858778
Aspergillus_fumigatus_B6894_CDC_5	18	15	3	0	scaffold_4	1682705	1732705
Aspergillus_fumigatus_B6894_CDC_5	3	2	1	0	scaffold_7	886340	936340
Aspergillus_fumigatus_B6894_CDC_5	22	18	4	0	scaffold_4	842293	892293
Aspergillus_fumigatus_B6894_CDC_5	18	14	4	0	scaffold_3	3578165	3628165
Aspergillus_fumigatus_B6894_CDC_5	20	19	1	0	scaffold_8	1507972	1557972
Aspergillus_fumigatus_B6894_CDC_5	23	22	1	0	scaffold_6	1230599	1280599
Aspergillus_fumigatus_B6894_CDC_5	0	0	0	0	scaffold_1	1816682	1866682
Aspergillus_fumigatus_B6894_CDC_5	22	22	0	0	scaffold_6	1796568	1846568
Aspergillus_fumigatus_B6894_CDC_5	14	12	2	0	scaffold_4	1877781	1927781
Aspergillus_fumigatus_B6894_CDC_5	19	15	4	0	scaffold_1	4178860	4228860
Aspergillus_fumigatus_B6894_CDC_5	17	16	1	0	scaffold_2	3461951	3511951
Aspergillus_fumigatus_B6894_CDC_5	17	17	0	0	scaffold_3	1248311	1298311
Aspergillus_fumigatus_B6894_CDC_5	21	20	1	0	scaffold_2	3955507	4005507
Aspergillus_fumigatus_B6894_CDC_5	18	17	1	0	scaffold_6	1921074	1971074
Aspergillus_fumigatus_B6894_CDC_5	18	15	3	0	scaffold_7	377483	427483
Aspergillus_fumigatus_B6894_CDC_5	20	18	2	0	scaffold_4	1285264	1335264
Aspergillus_fumigatus_B6894_CDC_5	19	19	0	0	scaffold_3	3540552	3590552
Aspergillus_fumigatus_B6894_CDC_5	15	4	11	0	scaffold_4	2631536	2681536
Aspergillus_fumigatus_B6894_CDC_5	23	23	0	0	scaffold_6	1237720	1287720
Aspergillus_fumigatus_B6894_CDC_5	27	24	3	0	scaffold_2	46455	96455
Aspergillus_fumigatus_B6894_CDC_5	18	17	1	0	scaffold_1	1496601	1546601
Aspergillus_fumigatus_B6894_CDC_5	23	20	3	0	scaffold_3	100025	150025
Aspergillus_fumigatus_B6894_CDC_5	22	19	3	0	scaffold_4	1694988	1744988
Aspergillus_fumigatus_B6894_CDC_5	18	17	1	0	scaffold_2	1208574	1258574
Aspergillus_fumigatus_B6894_CDC_5	22	21	1	0	scaffold_4	697600	747600
Aspergillus_fumigatus_B6894_CDC_5	5	3	2	0	scaffold_7	891747	941747
Aspergillus_fumigatus_B6894_CDC_5	19	11	8	0	scaffold_1	4503798	4553798
Aspergillus_fumigatus_B6894_CDC_5	18	16	2	0	scaffold_2	2982967	3032967
Aspergillus_fumigatus_B6894_CDC_5	27	23	4	0	scaffold_4	150934	200934
Aspergillus_fumigatus_B6894_CDC_5	19	18	1	0	scaffold_3	3171468	3221468
Aspergillus_fumigatus_B6894_CDC_5	18	17	1	0	scaffold_7	1250716	1300716
Aspergillus_fumigatus_B6894_CDC_5	19	17	2	0	scaffold_6	1617502	1667502
Aspergillus_fumigatus_B6894_CDC_5	22	20	2	0	scaffold_6	1989896	2039896
Aspergillus_fumigatus_B6894_CDC_5	20	20	0	0	scaffold_1	645473	695473
Aspergillus_fumigatus_B6894_CDC_5	15	14	1	0	scaffold_5	2863673	2913673
Aspergillus_fumigatus_B6894_CDC_5	13	12	1	0	scaffold_6	1208437	1258437
Aspergillus_fumigatus_B6894_CDC_5	15	10	5	0	scaffold_4	377581	427581
Aspergillus_fumigatus_B6894_CDC_5	19	15	4	0	scaffold_2	4474171	4524171
Aspergillus_fumigatus_B6894_CDC_5	23	22	1	0	scaffold_6	1336807	1386807
Aspergillus_fumigatus_B6894_CDC_5	18	16	2	0	scaffold_5	1727735	1777735
Aspergillus_fumigatus_B6894_CDC_5	22	21	1	0	scaffold_4	3293777	3343777
Aspergillus_fumigatus_B6894_CDC_5	13	13	0	0	scaffold_2	3863792	3913792
Aspergillus_fumigatus_B6894_CDC_5	21	19	2	0	scaffold_6	3105367	3155367
Aspergillus_fumigatus_B6894_CDC_5	24	22	2	0	scaffold_7	324695	374695
Aspergillus_fumigatus_B6894_CDC_5	20	19	1	0	scaffold_2	4214480	4264480
Aspergillus_fumigatus_B6894_CDC_5	14	14	0	0	scaffold_4	2888482	2938482
Aspergillus_fumigatus_B6894_CDC_5	16	16	0	0	scaffold_6	2623180	2673180
Aspergillus_fumigatus_B6894_CDC_5	19	19	0	0	scaffold_4	3307778	3357778
Aspergillus_fumigatus_B6894_CDC_5	0	0	0	0	scaffold_5	1223503	1273503
Aspergillus_fumigatus_B6894_CDC_5	23	20	3	0	scaffold_3	2154825	2204825
Aspergillus_fumigatus_B6894_CDC_5	22	20	2	0	scaffold_5	3655989	3705989
Aspergillus_fumigatus_B6894_CDC_5	19	19	0	0	scaffold_5	2124331	2174331
Aspergillus_fumigatus_B6894_CDC_5	9	7	2	0	scaffold_3	1119089	1169089
Aspergillus_fumigatus_B6894_CDC_5	18	17	1	0	scaffold_5	2088342	2138342
Aspergillus_fumigatus_B6894_CDC_5	17	14	3	0	scaffold_7	1609878	1659878
Aspergillus_fumigatus_B6894_CDC_5	17	16	1	0	scaffold_6	544612	594612
Aspergillus_fumigatus_B6894_CDC_5	13	13	0	0	scaffold_8	711968	761968
Aspergillus_fumigatus_B6894_CDC_5	25	21	4	0	scaffold_3	2296344	2346344
Aspergillus_fumigatus_B6894_CDC_5	19	17	2	0	scaffold_7	1087463	1137463
Aspergillus_fumigatus_B6894_CDC_5	21	19	2	0	scaffold_3	2339757	2389757
Aspergillus_fumigatus_B6894_CDC_5	17	17	0	0	scaffold_2	4168573	4218573
Aspergillus_fumigatus_B6894_CDC_5	22	20	2	0	scaffold_5	3728950	3778950
Aspergillus_fumigatus_B6894_CDC_5	21	18	3	0	scaffold_6	26109	76109
Aspergillus_fumigatus_B6894_CDC_5	22	20	2	0	scaffold_3	2327545	2377545
Aspergillus_fumigatus_B6894_CDC_5	17	15	2	0	scaffold_2	2278334	2328334
Aspergillus_fumigatus_B6894_CDC_5	19	19	0	0	scaffold_6	3201005	3251005
Aspergillus_fumigatus_B6894_CDC_5	18	18	0	0	scaffold_6	3193356	3243356
Aspergillus_fumigatus_B6894_CDC_5	21	19	2	0	scaffold_5	1879102	1929102
Aspergillus_fumigatus_B6894_CDC_5	24	22	2	0	scaffold_6	44060	94060
Aspergillus_fumigatus_B6894_CDC_5	15	14	1	0	scaffold_3	3039984	3089984
Aspergillus_fumigatus_B6894_CDC_5	13	13	0	0	scaffold_1	766829	816829
Aspergillus_fumigatus_B6894_CDC_5	21	21	0	0	scaffold_5	3180586	3230586
Aspergillus_fumigatus_B6894_CDC_5	22	18	4	0	scaffold_3	611806	661806
Aspergillus_fumigatus_B6894_CDC_5	28	23	5	0	scaffold_8	1658329	1708329
Aspergillus_fumigatus_B6894_CDC_5	17	14	3	0	scaffold_7	1416679	1466679
Aspergillus_fumigatus_B6894_CDC_5	24	23	1	0	scaffold_6	3569200	3619200
Aspergillus_fumigatus_B6894_CDC_5	18	17	1	0	scaffold_5	2438346	2488346
Aspergillus_fumigatus_B6894_CDC_5	18	16	2	0	scaffold_6	111617	161617
Aspergillus_fumigatus_B6894_CDC_5	17	15	2	0	scaffold_1	3456131	3506131
Aspergillus_fumigatus_B6894_CDC_5	23	22	1	0	scaffold_2	123287	173287
Aspergillus_fumigatus_B6894_CDC_5	22	21	1	0	scaffold_8	1481155	1531155
Aspergillus_fumigatus_B6894_CDC_5	19	19	0	0	scaffold_1	636781	686781
Aspergillus_fumigatus_B6894_CDC_5	21	20	1	0	scaffold_3	2217401	2267401
Aspergillus_fumigatus_B6894_CDC_5	17	17	0	0	scaffold_4	1804089	1854089
Aspergillus_fumigatus_B6894_CDC_5	17	16	1	0	scaffold_5	1454290	1504290
Aspergillus_fumigatus_B6894_CDC_5	13	13	0	0	scaffold_2	3885749	3935749
Aspergillus_fumigatus_B6894_CDC_5	22	18	4	0	scaffold_4	2820365	2870365
Aspergillus_fumigatus_B6894_CDC_5	24	24	0	0	scaffold_3	668314	718314
Aspergillus_fumigatus_B6894_CDC_5	17	17	0	0	scaffold_5	1099094	1149094
Aspergillus_fumigatus_B6894_CDC_5	15	13	2	0	scaffold_4	597170	647170
Aspergillus_fumigatus_B6894_CDC_5	18	15	3	0	scaffold_1	268555	318555
Aspergillus_fumigatus_B6894_CDC_5	21	18	3	0	scaffold_2	4372830	4422830
Aspergillus_fumigatus_B6894_CDC_5	14	12	2	0	scaffold_7	681398	731398
Aspergillus_fumigatus_B6894_CDC_5	7	7	0	0	scaffold_1	1796915	1846915
Aspergillus_fumigatus_B6894_CDC_5	18	17	1	0	scaffold_7	758055	808055
Aspergillus_fumigatus_B6894_CDC_5	20	12	8	0	scaffold_6	2191762	2241762
Aspergillus_fumigatus_B6894_CDC_5	20	20	0	0	scaffold_2	1558296	1608296
Aspergillus_fumigatus_B6894_CDC_5	20	19	1	0	scaffold_1	1373100	1423100
Aspergillus_fumigatus_B6894_CDC_5	19	19	0	0	scaffold_4	3379804	3429804
Aspergillus_fumigatus_B6894_CDC_5	19	17	2	0	scaffold_6	1256302	1306302
Aspergillus_fumigatus_B6894_CDC_5	15	15	0	0	scaffold_5	625991	675991
Aspergillus_fumigatus_B6894_CDC_5	18	18	0	0	scaffold_5	2676484	2726484
Aspergillus_fumigatus_B6894_CDC_5	24	20	4	0	scaffold_5	3354076	3404076
Aspergillus_fumigatus_B6894_CDC_5	15	15	0	0	scaffold_5	253494	303494
Aspergillus_fumigatus_B6894_CDC_5	18	18	0	0	scaffold_2	779222	829222
Aspergillus_fumigatus_B6894_CDC_5	18	16	2	0	scaffold_4	3598974	3648974
Aspergillus_fumigatus_B6894_CDC_5	19	18	1	0	scaffold_1	977393	1027393
Aspergillus_fumigatus_B6894_CDC_5	7	6	1	0	scaffold_6	3489464	3539464
Aspergillus_fumigatus_B6894_CDC_5	17	13	4	0	scaffold_2	4433337	4483337
Aspergillus_fumigatus_B6894_CDC_5	16	15	1	0	scaffold_7	1243368	1293368
Aspergillus_fumigatus_B6894_CDC_5	22	20	2	0	scaffold_2	2823119	2873119
Aspergillus_fumigatus_B6894_CDC_5	23	19	4	0	scaffold_1	4160859	4210859
Aspergillus_fumigatus_B6894_CDC_5	23	21	2	0	scaffold_3	590385	640385
Aspergillus_fumigatus_B6894_CDC_5	21	20	1	0	scaffold_3	516001	566001
Aspergillus_fumigatus_B6894_CDC_5	19	18	1	0	scaffold_6	933896	983896
Aspergillus_fumigatus_B6894_CDC_5	20	20	0	0	scaffold_5	2152959	2202959
Aspergillus_fumigatus_B6894_CDC_5	15	15	0	0	scaffold_3	3097617	3147617
Aspergillus_fumigatus_B6894_CDC_5	23	22	1	0	scaffold_6	1650110	1700110
Aspergillus_fumigatus_B6894_CDC_5	21	19	1	1	scaffold_3	2774649	2824649
Aspergillus_fumigatus_B6894_CDC_5	19	9	10	0	scaffold_3	788379	838379
Aspergillus_fumigatus_B6894_CDC_5	17	17	0	0	scaffold_4	1222843	1272843
Aspergillus_fumigatus_B6894_CDC_5	24	23	1	0	scaffold_2	4112577	4162577
Aspergillus_fumigatus_B6894_CDC_5	21	21	0	0	scaffold_2	1545695	1595695
Aspergillus_fumigatus_B6894_CDC_5	18	16	2	0	scaffold_6	3223044	3273044
Aspergillus_fumigatus_B6894_CDC_5	20	18	2	0	scaffold_4	777949	827949
Aspergillus_fumigatus_B6894_CDC_5	18	18	0	0	scaffold_6	1549065	1599065
Aspergillus_fumigatus_B6894_CDC_5	22	10	12	0	scaffold_5	932690	982690
Aspergillus_fumigatus_B6894_CDC_5	19	18	1	0	scaffold_6	2839249	2889249
Aspergillus_fumigatus_B6894_CDC_5	16	15	1	0	scaffold_4	2866462	2916462
Aspergillus_fumigatus_B6894_CDC_5	17	16	1	0	scaffold_6	3133654	3183654
Aspergillus_fumigatus_B6894_CDC_5	13	8	5	0	scaffold_4	3853737	3903737
Aspergillus_fumigatus_B6894_CDC_5	15	12	3	0	scaffold_2	531513	581513
Aspergillus_fumigatus_B6894_CDC_5	19	19	0	0	scaffold_4	3786973	3836973
Aspergillus_fumigatus_B6894_CDC_5	2	2	0	0	scaffold_2	1843828	1893828
Aspergillus_fumigatus_B6894_CDC_5	29	24	5	0	scaffold_4	162944	212944
Aspergillus_fumigatus_B6894_CDC_5	30	26	4	0	scaffold_2	30294	80294
Aspergillus_fumigatus_B6894_CDC_5	20	19	1	0	scaffold_4	1245434	1295434
Aspergillus_fumigatus_B6894_CDC_5	17	14	3	0	scaffold_1	4010180	4060180
Aspergillus_fumigatus_B6894_CDC_5	23	19	4	0	scaffold_5	37990	87990
Aspergillus_fumigatus_B6894_CDC_5	21	13	8	0	scaffold_6	2194922	2244922
Aspergillus_fumigatus_B6894_CDC_5	10	9	1	0	scaffold_4	2306442	2356442
Aspergillus_fumigatus_B6894_CDC_5	17	17	0	0	scaffold_1	733629	783629
Aspergillus_fumigatus_B6894_CDC_5	20	20	0	0	scaffold_5	544682	594682
Aspergillus_fumigatus_B6894_CDC_5	16	12	4	0	scaffold_8	456748	506748
Aspergillus_fumigatus_B6894_CDC_5	17	16	1	0	scaffold_6	3172229	3222229
Aspergillus_fumigatus_B6894_CDC_5	21	15	6	0	scaffold_4	3085737	3135737
Aspergillus_fumigatus_B6894_CDC_5	16	16	0	0	scaffold_2	3767052	3817052
Aspergillus_fumigatus_B6894_CDC_5	20	19	1	0	scaffold_3	3322546	3372546
Aspergillus_fumigatus_B6894_CDC_5	16	16	0	0	scaffold_1	971292	1021292
Aspergillus_fumigatus_B6894_CDC_5	13	12	1	0	scaffold_4	2301857	2351857
Aspergillus_fumigatus_B6894_CDC_5	21	19	2	0	scaffold_5	345107	395107
Aspergillus_fumigatus_B6894_CDC_5	16	14	2	0	scaffold_3	2620904	2670904
Aspergillus_fumigatus_B6894_CDC_5	14	12	2	0	scaffold_4	3611406	3661406
Aspergillus_fumigatus_B6894_CDC_5	16	15	1	0	scaffold_4	3496212	3546212
Aspergillus_fumigatus_B6894_CDC_5	24	22	2	0	scaffold_2	1420785	1470785
Aspergillus_fumigatus_B6894_CDC_5	17	17	0	0	scaffold_5	2661262	2711262
Aspergillus_fumigatus_B6894_CDC_5	23	23	0	0	scaffold_2	1571426	1621426
Aspergillus_fumigatus_B6894_CDC_5	13	13	0	0	scaffold_2	3883703	3933703
Aspergillus_fumigatus_B6894_CDC_5	17	15	2	0	scaffold_6	579968	629968
Aspergillus_fumigatus_B6894_CDC_5	18	17	1	0	scaffold_8	204880	254880
Aspergillus_fumigatus_B6894_CDC_5	20	17	3	0	scaffold_2	1710454	1760454
Aspergillus_fumigatus_B6894_CDC_5	19	18	1	0	scaffold_2	4309006	4359006
Aspergillus_fumigatus_B6894_CDC_5	17	15	2	0	scaffold_6	2714360	2764360
Aspergillus_fumigatus_B6894_CDC_5	16	15	1	0	scaffold_1	1583535	1633535
Aspergillus_fumigatus_B6894_CDC_5	16	15	1	0	scaffold_4	3831952	3881952
Aspergillus_fumigatus_B6894_CDC_5	21	17	4	0	scaffold_5	840248	890248
Aspergillus_fumigatus_B6894_CDC_5	20	17	3	0	scaffold_2	840484	890484
Aspergillus_fumigatus_B6894_CDC_5	21	18	3	0	scaffold_3	3869773	3919773
Aspergillus_fumigatus_B6894_CDC_5	18	17	1	0	scaffold_2	735152	785152
Aspergillus_fumigatus_B6894_CDC_5	19	18	1	0	scaffold_2	1202026	1252026
Aspergillus_fumigatus_B6894_CDC_5	19	17	2	0	scaffold_4	2677435	2727435
Aspergillus_fumigatus_B6894_CDC_5	19	19	0	0	scaffold_5	2133406	2183406
Aspergillus_fumigatus_B6894_CDC_5	20	18	2	0	scaffold_5	1287165	1337165
Aspergillus_fumigatus_B6894_CDC_5	28	25	3	0	scaffold_6	3369793	3419793
Aspergillus_fumigatus_B6894_CDC_5	16	16	0	0	scaffold_5	2669658	2719658
Aspergillus_fumigatus_B6894_CDC_5	15	14	1	0	scaffold_8	915124	965124
Aspergillus_fumigatus_B6894_CDC_5	19	18	1	0	scaffold_6	3066080	3116080
Aspergillus_fumigatus_B6894_CDC_5	22	21	1	0	scaffold_6	1333670	1383670
Aspergillus_fumigatus_B6894_CDC_5	21	16	5	0	scaffold_5	399637	449637
Aspergillus_fumigatus_B6894_CDC_5	17	0	17	0	scaffold_1	4292519	4342519
Aspergillus_fumigatus_B6894_CDC_5	23	20	3	0	scaffold_2	2079282	2129282
Aspergillus_fumigatus_B6894_CDC_5	19	17	2	0	scaffold_7	1257549	1307549
Aspergillus_fumigatus_B6894_CDC_5	20	19	1	0	scaffold_4	1215381	1265381
Aspergillus_fumigatus_B6894_CDC_5	17	13	4	0	scaffold_7	613243	663243
Aspergillus_fumigatus_B6894_CDC_5	20	14	6	0	scaffold_8	302273	352273
Aspergillus_fumigatus_B6894_CDC_5	16	16	0	0	scaffold_1	2702522	2752522
Aspergillus_fumigatus_B6894_CDC_5	22	22	0	0	scaffold_3	673998	723998
Aspergillus_fumigatus_B6894_CDC_5	15	13	2	0	scaffold_4	1868777	1918777
Aspergillus_fumigatus_B6894_CDC_5	26	19	7	0	scaffold_5	1683321	1733321
Aspergillus_fumigatus_B6894_CDC_5	20	19	1	0	scaffold_6	208632	258632
Aspergillus_fumigatus_B6894_CDC_5	18	15	3	0	scaffold_3	3800558	3850558
Aspergillus_fumigatus_B6894_CDC_5	15	14	1	0	scaffold_1	1270823	1320823
Aspergillus_fumigatus_B6894_CDC_5	18	15	3	0	scaffold_6	627226	677226
Aspergillus_fumigatus_B6894_CDC_5	20	12	8	0	scaffold_1	4502356	4552356
Aspergillus_fumigatus_B6894_CDC_5	16	10	6	0	scaffold_4	356126	406126
Aspergillus_fumigatus_B6894_CDC_5	20	20	0	0	scaffold_3	2244599	2294599
Aspergillus_fumigatus_B6894_CDC_5	20	18	2	0	scaffold_4	3695536	3745536
Aspergillus_fumigatus_B6894_CDC_5	18	17	1	0	scaffold_3	3081918	3131918
Aspergillus_fumigatus_B6894_CDC_5	21	20	1	0	scaffold_7	1730411	1780411
Aspergillus_fumigatus_B6894_CDC_5	4	4	0	0	scaffold_4	2390371	2440371
Aspergillus_fumigatus_B6894_CDC_5	12	11	1	0	scaffold_2	1908115	1958115
Aspergillus_fumigatus_B6894_CDC_5	17	15	2	0	scaffold_4	2711299	2761299
Aspergillus_fumigatus_B6894_CDC_5	18	18	0	0	scaffold_5	260773	310773
Aspergillus_fumigatus_B6894_CDC_5	21	18	3	0	scaffold_1	4669391	4719391
Aspergillus_fumigatus_B6894_CDC_5	23	21	2	0	scaffold_5	3733543	3783543
Aspergillus_fumigatus_B6894_CDC_5	20	19	1	0	scaffold_3	508808	558808
Aspergillus_fumigatus_B6894_CDC_5	22	21	1	0	scaffold_6	667297	717297
Aspergillus_fumigatus_B6894_CDC_5	16	7	9	0	scaffold_4	2643560	2693560
Aspergillus_fumigatus_B6894_CDC_5	19	17	2	0	scaffold_7	1091737	1141737
Aspergillus_fumigatus_B6894_CDC_5	15	15	0	0	scaffold_5	723205	773205
Aspergillus_fumigatus_B6894_CDC_5	19	18	1	0	scaffold_1	496782	546782
Aspergillus_fumigatus_B6894_CDC_5	22	20	2	0	scaffold_5	2388663	2438663
Aspergillus_fumigatus_B6894_CDC_5	17	16	1	0	scaffold_1	3731954	3781954
Aspergillus_fumigatus_B6894_CDC_5	19	18	1	0	scaffold_5	2094292	2144292
Aspergillus_fumigatus_B6894_CDC_5	16	14	2	0	scaffold_1	2905642	2955642
Aspergillus_fumigatus_B6894_CDC_5	28	25	3	0	scaffold_3	4043407	4093407
Aspergillus_fumigatus_B6894_CDC_5	19	15	4	0	scaffold_1	3151214	3201214
Aspergillus_fumigatus_B6894_CDC_5	22	19	3	0	scaffold_4	1691906	1741906
Aspergillus_fumigatus_B6894_CDC_5	20	19	1	0	scaffold_2	2192270	2242270
Aspergillus_fumigatus_B6894_CDC_5	16	15	1	0	scaffold_6	2687720	2737720
Aspergillus_fumigatus_B6894_CDC_5	18	15	2	1	scaffold_3	2738347	2788347
Aspergillus_fumigatus_B6894_CDC_5	15	11	4	0	scaffold_4	338072	388072
Aspergillus_fumigatus_B6894_CDC_5	14	13	1	0	scaffold_6	1405768	1455768
Aspergillus_fumigatus_B6894_CDC_5	21	18	3	0	scaffold_2	3131221	3181221
Aspergillus_fumigatus_B6894_CDC_5	20	17	3	0	scaffold_6	510315	560315
Aspergillus_fumigatus_B6894_CDC_5	18	17	1	0	scaffold_5	2444275	2494275
Aspergillus_fumigatus_B6894_CDC_5	21	21	0	0	scaffold_2	1552224	1602224
Aspergillus_fumigatus_B6894_CDC_5	26	21	5	0	scaffold_3	404529	454529
Aspergillus_fumigatus_B6894_CDC_5	21	20	1	0	scaffold_5	322374	372374
Aspergillus_fumigatus_B6894_CDC_5	26	24	2	0	scaffold_3	279510	329510
Aspergillus_fumigatus_B6894_CDC_5	16	15	1	0	scaffold_5	1364934	1414934
Aspergillus_fumigatus_B6894_CDC_5	20	17	3	0	scaffold_7	1442213	1492213
Aspergillus_fumigatus_B6894_CDC_5	18	17	1	0	scaffold_6	321668	371668
Aspergillus_fumigatus_B6894_CDC_5	19	18	1	0	scaffold_4	1103008	1153008
Aspergillus_fumigatus_B6894_CDC_5	18	18	0	0	scaffold_1	2501731	2551731
Aspergillus_fumigatus_B6894_CDC_5	14	9	5	0	scaffold_6	409517	459517
Aspergillus_fumigatus_B6894_CDC_5	14	11	3	0	scaffold_2	534241	584241
Aspergillus_fumigatus_B6894_CDC_5	18	17	1	0	scaffold_5	815977	865977
Aspergillus_fumigatus_B6894_CDC_5	24	24	0	0	scaffold_1	3770876	3820876
Aspergillus_fumigatus_B6894_CDC_5	17	17	0	0	scaffold_6	2975707	3025707
Aspergillus_fumigatus_B6894_CDC_5	21	19	2	0	scaffold_2	2266330	2316330
Aspergillus_fumigatus_B6894_CDC_5	20	16	4	0	scaffold_2	4444473	4494473
Aspergillus_fumigatus_B6894_CDC_5	22	21	1	0	scaffold_2	266961	316961
Aspergillus_fumigatus_B6894_CDC_5	18	18	0	0	scaffold_4	3391595	3441595
Aspergillus_fumigatus_B6894_CDC_5	18	13	5	0	scaffold_3	1068056	1118056
Aspergillus_fumigatus_B6894_CDC_5	13	12	1	0	scaffold_2	446797	496797
Aspergillus_fumigatus_B6894_CDC_5	22	15	7	0	scaffold_7	254034	304034
Aspergillus_fumigatus_B6894_CDC_5	11	9	2	0	scaffold_1	1106959	1156959
Aspergillus_fumigatus_B6894_CDC_5	19	16	3	0	scaffold_2	3702612	3752612
Aspergillus_fumigatus_B6894_CDC_5	19	18	1	0	scaffold_2	1588115	1638115
Aspergillus_fumigatus_B6894_CDC_5	20	18	2	0	scaffold_4	1511888	1561888
Aspergillus_fumigatus_B6894_CDC_5	19	18	1	0	scaffold_2	2119312	2169312
Aspergillus_fumigatus_B6894_CDC_5	12	8	4	0	scaffold_1	2039350	2089350
Aspergillus_fumigatus_B6894_CDC_5	19	19	0	0	scaffold_4	3310573	3360573
Aspergillus_fumigatus_B6894_CDC_5	16	16	0	0	scaffold_1	682660	732660
Aspergillus_fumigatus_B6894_CDC_5	17	14	3	0	scaffold_6	2403761	2453761
Aspergillus_fumigatus_B6894_CDC_5	22	21	1	0	scaffold_8	1487938	1537938
Aspergillus_fumigatus_B6894_CDC_5	18	17	1	0	scaffold_4	1008878	1058878
Aspergillus_fumigatus_B6894_CDC_5	20	19	1	0	scaffold_2	1725049	1775049
Aspergillus_fumigatus_B6894_CDC_5	18	17	1	0	scaffold_5	1633539	1683539
Aspergillus_fumigatus_B6894_CDC_5	19	18	1	0	scaffold_2	1769770	1819770
Aspergillus_fumigatus_B6894_CDC_5	15	15	0	0	scaffold_2	4163481	4213481
Aspergillus_fumigatus_B6894_CDC_5	21	21	0	0	scaffold_6	1830904	1880904
Aspergillus_fumigatus_B6894_CDC_5	22	14	8	0	scaffold_7	245465	295465
Aspergillus_fumigatus_B6894_CDC_5	19	19	0	0	scaffold_8	1287126	1337126
Aspergillus_fumigatus_B6894_CDC_5	18	15	3	0	scaffold_6	2151222	2201222
Aspergillus_fumigatus_B6894_CDC_5	19	19	0	0	scaffold_7	1071774	1121774
Aspergillus_fumigatus_B6894_CDC_5	25	21	4	0	scaffold_6	3556013	3606013
Aspergillus_fumigatus_B6894_CDC_5	17	13	4	0	scaffold_8	102390	152390
Aspergillus_fumigatus_B6894_CDC_5	21	18	3	0	scaffold_1	4667200	4717200
Aspergillus_fumigatus_B6894_CDC_5	20	18	2	0	scaffold_4	1184623	1234623
Aspergillus_fumigatus_B6894_CDC_5	19	16	3	0	scaffold_2	1709291	1759291
Aspergillus_fumigatus_B6894_CDC_5	14	10	4	0	scaffold_3	3395736	3445736
Aspergillus_fumigatus_B6894_CDC_5	18	16	2	0	scaffold_6	533535	583535
Aspergillus_fumigatus_B6894_CDC_5	16	15	1	0	scaffold_4	3505987	3555987
Aspergillus_fumigatus_B6894_CDC_5	20	19	1	0	scaffold_3	2220106	2270106
Aspergillus_fumigatus_B6894_CDC_5	20	19	1	0	scaffold_6	1894773	1944773
Aspergillus_fumigatus_B6894_CDC_5	24	22	2	0	scaffold_8	144203	194203
Aspergillus_fumigatus_B6894_CDC_5	17	16	1	0	scaffold_6	3145641	3195641
Aspergillus_fumigatus_B6894_CDC_5	21	21	0	0	scaffold_6	2259494	2309494
Aspergillus_fumigatus_B6894_CDC_5	19	16	3	0	scaffold_3	2020427	2070427
Aspergillus_fumigatus_B6894_CDC_5	16	16	0	0	scaffold_2	3764559	3814559
Aspergillus_fumigatus_B6894_CDC_5	7	6	1	0	scaffold_2	1830756	1880756
Aspergillus_fumigatus_B6894_CDC_5	17	17	0	0	scaffold_3	1838493	1888493
Aspergillus_fumigatus_B6894_CDC_5	24	20	4	0	scaffold_1	2971995	3021995
Aspergillus_fumigatus_B6894_CDC_5	21	21	0	0	scaffold_8	1019976	1069976
Aspergillus_fumigatus_B6894_CDC_5	22	19	3	0	scaffold_1	3810705	3860705
Aspergillus_fumigatus_B6894_CDC_5	19	18	1	0	scaffold_5	1609537	1659537
Aspergillus_fumigatus_B6894_CDC_5	15	15	0	0	scaffold_2	696442	746442
Aspergillus_fumigatus_B6894_CDC_5	26	24	2	0	scaffold_4	2259529	2309529
Aspergillus_fumigatus_B6894_CDC_5	17	15	2	0	scaffold_2	1804484	1854484
Aspergillus_fumigatus_B6894_CDC_5	22	20	2	0	scaffold_3	66935	116935
Aspergillus_fumigatus_B6894_CDC_5	15	15	0	0	scaffold_4	977147	1027147
Aspergillus_fumigatus_B6894_CDC_5	16	15	1	0	scaffold_5	2860494	2910494
Aspergillus_fumigatus_B6894_CDC_5	14	13	1	0	scaffold_4	3144564	3194564
Aspergillus_fumigatus_B6894_CDC_5	16	14	2	0	scaffold_4	1904330	1954330
Aspergillus_fumigatus_B6894_CDC_5	25	17	8	0	scaffold_5	1713159	1763159
Aspergillus_fumigatus_B6894_CDC_5	17	11	6	0	scaffold_4	348730	398730
Aspergillus_fumigatus_B6894_CDC_5	18	10	8	0	scaffold_4	2432660	2482660
Aspergillus_fumigatus_B6894_CDC_5	22	22	0	0	scaffold_4	3747983	3797983
Aspergillus_fumigatus_B6894_CDC_5	21	19	2	0	scaffold_6	2045463	2095463
Aspergillus_fumigatus_B6894_CDC_5	20	20	0	0	scaffold_3	1211794	1261794
Aspergillus_fumigatus_B6894_CDC_5	23	19	4	0	scaffold_6	141470	191470
Aspergillus_fumigatus_B6894_CDC_5	25	20	5	0	scaffold_5	3678938	3728938
Aspergillus_fumigatus_B6894_CDC_5	20	19	1	0	scaffold_7	1078198	1128198
Aspergillus_fumigatus_B6894_CDC_5	20	18	2	0	scaffold_4	2173197	2223197
Aspergillus_fumigatus_B6894_CDC_5	20	17	3	0	scaffold_4	1686354	1736354
Aspergillus_fumigatus_B6894_CDC_5	30	25	5	0	scaffold_6	3356464	3406464
Aspergillus_fumigatus_B6894_CDC_5	19	17	2	0	scaffold_6	757518	807518
Aspergillus_fumigatus_B6894_CDC_5	16	15	1	0	scaffold_2	428429	478429
Aspergillus_fumigatus_B6894_CDC_5	17	16	1	0	scaffold_4	1008231	1058231
Aspergillus_fumigatus_B6894_CDC_5	16	15	1	0	scaffold_2	2756628	2806628
Aspergillus_fumigatus_B6894_CDC_5	21	20	1	0	scaffold_3	498456	548456
Aspergillus_fumigatus_B6894_CDC_5	22	21	1	0	scaffold_3	496012	546012
Aspergillus_fumigatus_B6894_CDC_5	15	14	1	0	scaffold_5	1422667	1472667
Aspergillus_fumigatus_B6894_CDC_5	15	13	2	0	scaffold_3	3408616	3458616
Aspergillus_fumigatus_B6894_CDC_5	18	18	0	0	scaffold_3	1394587	1444587
Aspergillus_fumigatus_B6894_CDC_5	18	16	2	0	scaffold_8	625694	675694
Aspergillus_fumigatus_B6894_CDC_5	20	15	5	0	scaffold_5	3569265	3619265
Aspergillus_fumigatus_B6894_CDC_5	17	16	1	0	scaffold_3	3052115	3102115
Aspergillus_fumigatus_B6894_CDC_5	16	16	0	0	scaffold_3	1825428	1875428
Aspergillus_fumigatus_B6894_CDC_5	24	22	2	0	scaffold_3	1700282	1750282
Aspergillus_fumigatus_B6894_CDC_5	20	18	2	0	scaffold_4	3697002	3747002
Aspergillus_fumigatus_B6894_CDC_5	22	13	9	0	scaffold_4	109835	159835
Aspergillus_fumigatus_B6894_CDC_5	28	18	10	0	scaffold_1	86457	136457
Aspergillus_fumigatus_B6894_CDC_5	1	1	0	0	scaffold_3	3687959	3737959
Aspergillus_fumigatus_B6894_CDC_5	17	16	1	0	scaffold_3	1414661	1464661
Aspergillus_fumigatus_B6894_CDC_5	21	20	1	0	scaffold_8	1022442	1072442
