STRAIN	TOTAL	CORE	ACCESSORY	SINGLETON	CHROM	START	END
Aspergillus_fumigatus_IFM_55369	38	34	4	0	scaffold_1	1401234	1501234
Aspergillus_fumigatus_IFM_55369	43	34	9	0	scaffold_2	3937682	4037682
Aspergillus_fumigatus_IFM_55369	48	45	3	0	scaffold_1	129690	229690
Aspergillus_fumigatus_IFM_55369	36	32	4	0	scaffold_4	3524452	3624452
Aspergillus_fumigatus_IFM_55369	22	19	3	0	scaffold_5	142679	242679
Aspergillus_fumigatus_IFM_55369	37	34	3	0	scaffold_6	3182590	3282590
Aspergillus_fumigatus_IFM_55369	39	39	0	0	scaffold_1	337111	437111
Aspergillus_fumigatus_IFM_55369	47	43	4	0	scaffold_5	2603904	2703904
Aspergillus_fumigatus_IFM_55369	38	38	0	0	scaffold_2	2066102	2166102
Aspergillus_fumigatus_IFM_55369	30	27	3	0	scaffold_7	787223	887223
Aspergillus_fumigatus_IFM_55369	42	38	4	0	scaffold_1	3420629	3520629
Aspergillus_fumigatus_IFM_55369	48	42	6	0	scaffold_4	3931337	4031337
Aspergillus_fumigatus_IFM_55369	30	30	0	0	scaffold_1	1653060	1753060
Aspergillus_fumigatus_IFM_55369	32	27	5	0	scaffold_1	4031559	4131559
Aspergillus_fumigatus_IFM_55369	35	35	0	0	scaffold_1	997217	1097217
Aspergillus_fumigatus_IFM_55369	39	36	3	0	scaffold_6	1964596	2064596
Aspergillus_fumigatus_IFM_55369	33	32	1	0	scaffold_8	1288409	1388409
Aspergillus_fumigatus_IFM_55369	40	32	8	0	scaffold_6	2168875	2268875
Aspergillus_fumigatus_IFM_55369	34	29	5	0	scaffold_3	3449445	3549445
Aspergillus_fumigatus_IFM_55369	34	31	3	0	scaffold_3	2689796	2789796
Aspergillus_fumigatus_IFM_55369	42	40	2	0	scaffold_3	2270740	2370740
Aspergillus_fumigatus_IFM_55369	46	43	3	0	scaffold_3	411055	511055
Aspergillus_fumigatus_IFM_55369	30	28	2	0	scaffold_3	2198815	2298815
Aspergillus_fumigatus_IFM_55369	27	22	5	0	scaffold_5	220304	320304
Aspergillus_fumigatus_IFM_55369	31	30	1	0	scaffold_7	560117	660117
Aspergillus_fumigatus_IFM_55369	32	28	4	0	scaffold_2	1013167	1113167
Aspergillus_fumigatus_IFM_55369	33	30	3	0	scaffold_1	2998909	3098909
Aspergillus_fumigatus_IFM_55369	50	43	7	0	scaffold_4	3940972	4040972
Aspergillus_fumigatus_IFM_55369	36	31	5	0	scaffold_3	2085064	2185064
Aspergillus_fumigatus_IFM_55369	42	39	3	0	scaffold_1	2244850	2344850
Aspergillus_fumigatus_IFM_55369	37	32	5	0	scaffold_2	3816701	3916701
Aspergillus_fumigatus_IFM_55369	36	35	1	0	scaffold_1	1800178	1900178
Aspergillus_fumigatus_IFM_55369	50	38	12	0	scaffold_2	64159	164159
Aspergillus_fumigatus_IFM_55369	39	31	8	0	scaffold_4	1858383	1958383
Aspergillus_fumigatus_IFM_55369	46	41	5	0	scaffold_3	81952	181952
Aspergillus_fumigatus_IFM_55369	25	22	3	0	scaffold_6	360921	460921
Aspergillus_fumigatus_IFM_55369	40	39	1	0	scaffold_2	471199	571199
Aspergillus_fumigatus_IFM_55369	33	31	2	0	scaffold_2	1202783	1302783
Aspergillus_fumigatus_IFM_55369	34	34	0	0	scaffold_4	1188267	1288267
Aspergillus_fumigatus_IFM_55369	38	18	20	0	scaffold_3	793773	893773
Aspergillus_fumigatus_IFM_55369	38	33	5	0	scaffold_2	2995433	3095433
Aspergillus_fumigatus_IFM_55369	37	35	2	0	scaffold_3	3211858	3311858
Aspergillus_fumigatus_IFM_55369	37	37	0	0	scaffold_6	2873412	2973412
Aspergillus_fumigatus_IFM_55369	42	34	8	0	scaffold_4	191430	291430
Aspergillus_fumigatus_IFM_55369	38	35	3	0	scaffold_8	1185106	1285106
Aspergillus_fumigatus_IFM_55369	42	40	2	0	scaffold_5	2641189	2741189
Aspergillus_fumigatus_IFM_55369	34	31	3	0	scaffold_1	838906	938906
Aspergillus_fumigatus_IFM_55369	42	37	5	0	scaffold_4	556566	656566
Aspergillus_fumigatus_IFM_55369	40	37	3	0	scaffold_5	790041	890041
Aspergillus_fumigatus_IFM_55369	36	30	6	0	scaffold_6	94966	194966
Aspergillus_fumigatus_IFM_55369	38	36	2	0	scaffold_5	990486	1090486
Aspergillus_fumigatus_IFM_55369	45	40	5	0	scaffold_3	2403935	2503935
Aspergillus_fumigatus_IFM_55369	47	42	5	0	scaffold_7	1549735	1649735
Aspergillus_fumigatus_IFM_55369	44	36	8	0	scaffold_7	166094	266094
Aspergillus_fumigatus_IFM_55369	37	37	0	0	scaffold_2	2042331	2142331
Aspergillus_fumigatus_IFM_55369	41	36	5	0	scaffold_4	580377	680377
Aspergillus_fumigatus_IFM_55369	34	34	0	0	scaffold_1	691836	791836
Aspergillus_fumigatus_IFM_55369	38	36	2	0	scaffold_6	977689	1077689
Aspergillus_fumigatus_IFM_55369	44	39	5	0	scaffold_1	3248066	3348066
Aspergillus_fumigatus_IFM_55369	35	31	4	0	scaffold_3	3436533	3536533
Aspergillus_fumigatus_IFM_55369	39	38	1	0	scaffold_3	4096092	4196092
Aspergillus_fumigatus_IFM_55369	33	31	2	0	scaffold_3	1913225	2013225
Aspergillus_fumigatus_IFM_55369	41	39	2	0	scaffold_6	1705798	1805798
Aspergillus_fumigatus_IFM_55369	47	39	8	0	scaffold_8	297004	397004
Aspergillus_fumigatus_IFM_55369	34	30	4	0	scaffold_6	2370538	2470538
Aspergillus_fumigatus_IFM_55369	41	37	4	0	scaffold_7	432636	532636
Aspergillus_fumigatus_IFM_55369	35	26	9	0	scaffold_2	3341301	3441301
Aspergillus_fumigatus_IFM_55369	33	32	1	0	scaffold_6	2910466	3010466
Aspergillus_fumigatus_IFM_55369	34	30	4	0	scaffold_1	3645424	3745424
Aspergillus_fumigatus_IFM_55369	32	31	1	0	scaffold_1	3757852	3857852
Aspergillus_fumigatus_IFM_55369	32	29	3	0	scaffold_3	3492932	3592932
Aspergillus_fumigatus_IFM_55369	42	38	4	0	scaffold_1	4292828	4392828
Aspergillus_fumigatus_IFM_55369	40	37	3	0	scaffold_3	1774484	1874484
Aspergillus_fumigatus_IFM_55369	37	33	4	0	scaffold_3	2529969	2629969
Aspergillus_fumigatus_IFM_55369	37	35	2	0	scaffold_7	5531	105531
Aspergillus_fumigatus_IFM_55369	33	28	5	0	scaffold_8	582889	682889
Aspergillus_fumigatus_IFM_55369	37	32	5	0	scaffold_8	242963	342963
Aspergillus_fumigatus_IFM_55369	36	35	1	0	scaffold_1	1797660	1897660
Aspergillus_fumigatus_IFM_55369	40	35	5	0	scaffold_1	898961	998961
Aspergillus_fumigatus_IFM_55369	34	32	2	0	scaffold_8	1001390	1101390
Aspergillus_fumigatus_IFM_55369	37	36	1	0	scaffold_2	1298951	1398951
Aspergillus_fumigatus_IFM_55369	41	38	3	0	scaffold_3	125359	225359
Aspergillus_fumigatus_IFM_55369	32	31	1	0	scaffold_4	2096190	2196190
Aspergillus_fumigatus_IFM_55369	22	19	3	0	scaffold_5	1976765	2076765
Aspergillus_fumigatus_IFM_55369	43	35	8	0	scaffold_5	2491073	2591073
Aspergillus_fumigatus_IFM_55369	36	33	3	0	scaffold_3	2522280	2622280
Aspergillus_fumigatus_IFM_55369	38	36	2	0	scaffold_2	2145108	2245108
Aspergillus_fumigatus_IFM_55369	36	34	2	0	scaffold_8	973005	1073005
Aspergillus_fumigatus_IFM_55369	40	38	2	0	scaffold_6	929621	1029621
Aspergillus_fumigatus_IFM_55369	41	36	5	0	scaffold_1	3204763	3304763
Aspergillus_fumigatus_IFM_55369	38	36	2	0	scaffold_6	832013	932013
Aspergillus_fumigatus_IFM_55369	34	29	5	0	scaffold_7	41857	141857
Aspergillus_fumigatus_IFM_55369	34	31	3	0	scaffold_1	553962	653962
Aspergillus_fumigatus_IFM_55369	34	31	3	0	scaffold_6	154718	254718
Aspergillus_fumigatus_IFM_55369	39	39	0	0	scaffold_4	1145819	1245819
Aspergillus_fumigatus_IFM_55369	32	30	2	0	scaffold_3	1514885	1614885
Aspergillus_fumigatus_IFM_55369	36	32	4	0	scaffold_6	3168278	3268278
Aspergillus_fumigatus_IFM_55369	37	21	16	0	scaffold_5	2279004	2379004
Aspergillus_fumigatus_IFM_55369	33	30	3	0	scaffold_2	989770	1089770
Aspergillus_fumigatus_IFM_55369	35	35	0	0	scaffold_6	2901072	3001072
Aspergillus_fumigatus_IFM_55369	44	40	4	0	scaffold_5	2824567	2924567
Aspergillus_fumigatus_IFM_55369	32	30	2	0	scaffold_1	3721763	3821763
Aspergillus_fumigatus_IFM_55369	32	30	2	0	scaffold_3	3130443	3230443
Aspergillus_fumigatus_IFM_55369	44	41	3	0	scaffold_4	1032748	1132748
Aspergillus_fumigatus_IFM_55369	36	34	2	0	scaffold_2	2130970	2230970
Aspergillus_fumigatus_IFM_55369	33	33	0	0	scaffold_4	2887796	2987796
Aspergillus_fumigatus_IFM_55369	44	41	3	0	scaffold_7	139294	239294
Aspergillus_fumigatus_IFM_55369	36	31	5	0	scaffold_8	549583	649583
Aspergillus_fumigatus_IFM_55369	28	24	4	0	scaffold_2	1043487	1143487
Aspergillus_fumigatus_IFM_55369	28	26	2	0	scaffold_1	4474387	4574387
Aspergillus_fumigatus_IFM_55369	38	34	4	0	scaffold_2	2665022	2765022
Aspergillus_fumigatus_IFM_55369	38	35	3	0	scaffold_1	2189933	2289933
Aspergillus_fumigatus_IFM_55369	34	31	3	0	scaffold_2	2870050	2970050
Aspergillus_fumigatus_IFM_55369	38	36	2	0	scaffold_4	1369053	1469053
Aspergillus_fumigatus_IFM_55369	30	26	4	0	scaffold_2	1032614	1132614
Aspergillus_fumigatus_IFM_55369	39	35	4	0	scaffold_3	3619346	3719346
Aspergillus_fumigatus_IFM_55369	36	36	0	0	scaffold_4	1185050	1285050
Aspergillus_fumigatus_IFM_55369	33	28	5	0	scaffold_1	1944777	2044777
Aspergillus_fumigatus_IFM_55369	41	40	1	0	scaffold_2	478931	578931
Aspergillus_fumigatus_IFM_55369	29	29	0	0	scaffold_1	3347369	3447369
Aspergillus_fumigatus_IFM_55369	32	30	2	0	scaffold_4	2077450	2177450
Aspergillus_fumigatus_IFM_55369	37	36	1	0	scaffold_3	4101809	4201809
Aspergillus_fumigatus_IFM_55369	30	28	2	0	scaffold_5	299389	399389
Aspergillus_fumigatus_IFM_55369	39	38	1	0	scaffold_6	1673798	1773798
Aspergillus_fumigatus_IFM_55369	39	36	3	0	scaffold_4	2495622	2595622
Aspergillus_fumigatus_IFM_55369	26	23	3	0	scaffold_5	253814	353814
Aspergillus_fumigatus_IFM_55369	39	25	14	0	scaffold_3	1078288	1178288
Aspergillus_fumigatus_IFM_55369	46	39	7	0	scaffold_4	2688702	2788702
Aspergillus_fumigatus_IFM_55369	15	14	1	0	scaffold_4	1301697	1401697
Aspergillus_fumigatus_IFM_55369	49	40	9	0	scaffold_8	319321	419321
Aspergillus_fumigatus_IFM_55369	40	37	3	0	scaffold_6	2254554	2354554
Aspergillus_fumigatus_IFM_55369	45	40	5	0	scaffold_5	3520152	3620152
Aspergillus_fumigatus_IFM_55369	36	31	5	0	scaffold_2	1606237	1706237
Aspergillus_fumigatus_IFM_55369	42	35	7	0	scaffold_4	1741608	1841608
Aspergillus_fumigatus_IFM_55369	49	41	8	0	scaffold_4	295958	395958
Aspergillus_fumigatus_IFM_55369	38	28	10	0	scaffold_6	2114120	2214120
Aspergillus_fumigatus_IFM_55369	35	34	1	0	scaffold_5	3103646	3203646
Aspergillus_fumigatus_IFM_55369	29	26	3	0	scaffold_4	2311711	2411711
Aspergillus_fumigatus_IFM_55369	50	41	9	0	scaffold_8	323540	423540
Aspergillus_fumigatus_IFM_55369	36	29	7	0	scaffold_2	4230009	4330009
Aspergillus_fumigatus_IFM_55369	34	31	3	0	scaffold_3	3470340	3570340
Aspergillus_fumigatus_IFM_55369	33	32	1	0	scaffold_6	2968530	3068530
Aspergillus_fumigatus_IFM_55369	36	33	3	0	scaffold_2	1143838	1243838
Aspergillus_fumigatus_IFM_55369	34	32	2	0	scaffold_8	1001488	1101488
Aspergillus_fumigatus_IFM_55369	22	9	13	0	scaffold_4	115407	215407
Aspergillus_fumigatus_IFM_55369	49	41	8	0	scaffold_6	3565891	3665891
Aspergillus_fumigatus_IFM_55369	31	30	1	0	scaffold_1	1073515	1173515
Aspergillus_fumigatus_IFM_55369	42	37	5	0	scaffold_5	525325	625325
Aspergillus_fumigatus_IFM_55369	45	41	4	0	scaffold_2	4332021	4432021
Aspergillus_fumigatus_IFM_55369	42	39	3	0	scaffold_8	168997	268997
Aspergillus_fumigatus_IFM_55369	37	31	6	0	scaffold_4	1846387	1946387
Aspergillus_fumigatus_IFM_55369	36	32	4	0	scaffold_1	1249696	1349696
Aspergillus_fumigatus_IFM_55369	34	29	5	0	scaffold_3	3449506	3549506
Aspergillus_fumigatus_IFM_55369	36	36	0	0	scaffold_2	575666	675666
Aspergillus_fumigatus_IFM_55369	40	36	4	0	scaffold_6	58628	158628
Aspergillus_fumigatus_IFM_55369	36	35	1	0	scaffold_5	1675372	1775372
Aspergillus_fumigatus_IFM_55369	36	33	3	0	scaffold_4	3574493	3674493
Aspergillus_fumigatus_IFM_55369	41	37	4	0	scaffold_8	680798	780798
Aspergillus_fumigatus_IFM_55369	44	41	3	0	scaffold_2	4346916	4446916
Aspergillus_fumigatus_IFM_55369	15	15	0	0	scaffold_4	1306917	1406917
Aspergillus_fumigatus_IFM_55369	41	38	3	0	scaffold_6	2450303	2550303
Aspergillus_fumigatus_IFM_55369	37	34	3	0	scaffold_2	810276	910276
Aspergillus_fumigatus_IFM_55369	33	31	2	0	scaffold_5	321868	421868
Aspergillus_fumigatus_IFM_55369	30	26	4	0	scaffold_2	1055697	1155697
Aspergillus_fumigatus_IFM_55369	27	24	3	0	scaffold_2	1685946	1785946
Aspergillus_fumigatus_IFM_55369	44	42	2	0	scaffold_5	587287	687287
Aspergillus_fumigatus_IFM_55369	35	33	2	0	scaffold_6	1221559	1321559
Aspergillus_fumigatus_IFM_55369	40	36	4	0	scaffold_6	3266324	3366324
Aspergillus_fumigatus_IFM_55369	37	32	5	0	scaffold_1	1323091	1423091
Aspergillus_fumigatus_IFM_55369	36	36	0	0	scaffold_4	2156704	2256704
Aspergillus_fumigatus_IFM_55369	47	42	5	0	scaffold_7	1547104	1647104
Aspergillus_fumigatus_IFM_55369	41	34	7	0	scaffold_4	1744412	1844412
Aspergillus_fumigatus_IFM_55369	37	33	4	0	scaffold_1	3976246	4076246
Aspergillus_fumigatus_IFM_55369	38	35	3	0	scaffold_5	698160	798160
Aspergillus_fumigatus_IFM_55369	38	37	1	0	scaffold_6	1303198	1403198
Aspergillus_fumigatus_IFM_55369	43	42	1	0	scaffold_6	1813953	1913953
Aspergillus_fumigatus_IFM_55369	45	43	2	0	scaffold_3	4067433	4167433
Aspergillus_fumigatus_IFM_55369	33	27	6	0	scaffold_3	3877206	3977206
Aspergillus_fumigatus_IFM_55369	32	30	2	0	scaffold_3	1460738	1560738
Aspergillus_fumigatus_IFM_55369	32	30	2	0	scaffold_6	2561162	2661162
Aspergillus_fumigatus_IFM_55369	40	37	3	0	scaffold_4	2785897	2885897
Aspergillus_fumigatus_IFM_55369	37	36	1	0	scaffold_8	1056385	1156385
Aspergillus_fumigatus_IFM_55369	29	28	1	0	scaffold_3	1338382	1438382
Aspergillus_fumigatus_IFM_55369	38	36	2	0	scaffold_6	899548	999548
Aspergillus_fumigatus_IFM_55369	34	32	2	0	scaffold_6	1227260	1327260
Aspergillus_fumigatus_IFM_55369	38	36	2	0	scaffold_6	817676	917676
Aspergillus_fumigatus_IFM_55369	42	37	5	0	scaffold_2	297692	397692
Aspergillus_fumigatus_IFM_55369	37	34	3	0	scaffold_5	2015147	2115147
Aspergillus_fumigatus_IFM_55369	42	38	4	0	scaffold_6	3374416	3474416
Aspergillus_fumigatus_IFM_55369	36	30	6	0	scaffold_2	4235480	4335480
Aspergillus_fumigatus_IFM_55369	34	33	1	0	scaffold_3	3148370	3248370
Aspergillus_fumigatus_IFM_55369	39	28	11	0	scaffold_3	544365	644365
Aspergillus_fumigatus_IFM_55369	37	28	9	0	scaffold_5	2922360	3022360
Aspergillus_fumigatus_IFM_55369	33	29	4	0	scaffold_8	1575492	1675492
Aspergillus_fumigatus_IFM_55369	26	23	3	0	scaffold_6	354485	454485
Aspergillus_fumigatus_IFM_55369	35	35	0	0	scaffold_1	1596532	1696532
Aspergillus_fumigatus_IFM_55369	34	34	0	0	scaffold_4	3331247	3431247
Aspergillus_fumigatus_IFM_55369	40	31	9	0	scaffold_6	3541744	3641744
Aspergillus_fumigatus_IFM_55369	34	24	10	0	scaffold_5	2159977	2259977
Aspergillus_fumigatus_IFM_55369	32	31	1	0	scaffold_5	3290837	3390837
Aspergillus_fumigatus_IFM_55369	35	32	3	0	scaffold_4	1667828	1767828
Aspergillus_fumigatus_IFM_55369	33	31	2	0	scaffold_2	3535690	3635690
Aspergillus_fumigatus_IFM_55369	35	34	1	0	scaffold_1	3102516	3202516
Aspergillus_fumigatus_IFM_55369	38	33	5	0	scaffold_3	18865	118865
Aspergillus_fumigatus_IFM_55369	38	34	4	0	scaffold_3	3610271	3710271
Aspergillus_fumigatus_IFM_55369	40	37	3	0	scaffold_6	2459464	2559464
Aspergillus_fumigatus_IFM_55369	37	33	4	0	scaffold_1	3175392	3275392
Aspergillus_fumigatus_IFM_55369	45	38	7	0	scaffold_7	1502640	1602640
Aspergillus_fumigatus_IFM_55369	28	24	3	1	scaffold_8	757336	857336
Aspergillus_fumigatus_IFM_55369	41	37	4	0	scaffold_1	3403958	3503958
Aspergillus_fumigatus_IFM_55369	49	38	11	0	scaffold_4	288484	388484
Aspergillus_fumigatus_IFM_55369	39	37	2	0	scaffold_6	762426	862426
Aspergillus_fumigatus_IFM_55369	42	41	1	0	scaffold_7	844304	944304
Aspergillus_fumigatus_IFM_55369	40	3	37	0	scaffold_3	1004593	1104593
Aspergillus_fumigatus_IFM_55369	26	1	25	0	scaffold_4	56019	156019
Aspergillus_fumigatus_IFM_55369	42	38	4	0	scaffold_2	4287310	4387310
Aspergillus_fumigatus_IFM_55369	38	36	2	0	scaffold_4	967785	1067785
Aspergillus_fumigatus_IFM_55369	21	18	2	1	scaffold_8	809266	909266
Aspergillus_fumigatus_IFM_55369	38	35	3	0	scaffold_5	3490273	3590273
Aspergillus_fumigatus_IFM_55369	34	30	4	0	scaffold_1	4381369	4481369
Aspergillus_fumigatus_IFM_55369	44	40	4	0	scaffold_3	2462327	2562327
Aspergillus_fumigatus_IFM_55369	33	24	9	0	scaffold_3	3807820	3907820
Aspergillus_fumigatus_IFM_55369	36	32	4	0	scaffold_1	4399844	4499844
Aspergillus_fumigatus_IFM_55369	21	20	1	0	scaffold_8	827170	927170
Aspergillus_fumigatus_IFM_55369	35	35	0	0	scaffold_4	688851	788851
Aspergillus_fumigatus_IFM_55369	42	37	5	0	scaffold_4	3477957	3577957
Aspergillus_fumigatus_IFM_55369	33	31	2	0	scaffold_2	851586	951586
Aspergillus_fumigatus_IFM_55369	40	20	20	0	scaffold_3	781715	881715
Aspergillus_fumigatus_IFM_55369	39	37	2	0	scaffold_6	900803	1000803
Aspergillus_fumigatus_IFM_55369	38	34	4	0	scaffold_1	1726202	1826202
Aspergillus_fumigatus_IFM_55369	35	32	3	0	scaffold_5	3031354	3131354
Aspergillus_fumigatus_IFM_55369	40	38	2	0	scaffold_6	2246299	2346299
Aspergillus_fumigatus_IFM_55369	40	38	2	0	scaffold_5	1013064	1113064
Aspergillus_fumigatus_IFM_55369	31	29	2	0	scaffold_1	3330083	3430083
Aspergillus_fumigatus_IFM_55369	34	34	0	0	scaffold_4	3191194	3291194
Aspergillus_fumigatus_IFM_55369	44	42	2	0	scaffold_4	1051416	1151416
Aspergillus_fumigatus_IFM_55369	37	34	3	0	scaffold_5	3068608	3168608
Aspergillus_fumigatus_IFM_55369	40	34	6	0	scaffold_2	260578	360578
Aspergillus_fumigatus_IFM_55369	41	34	7	0	scaffold_4	231787	331787
Aspergillus_fumigatus_IFM_55369	37	36	1	0	scaffold_4	1362365	1462365
Aspergillus_fumigatus_IFM_55369	39	36	3	0	scaffold_1	2203809	2303809
Aspergillus_fumigatus_IFM_55369	35	26	9	0	scaffold_4	3985441	4085441
Aspergillus_fumigatus_IFM_55369	30	29	1	0	scaffold_3	4124945	4224945
Aspergillus_fumigatus_IFM_55369	47	45	2	0	scaffold_3	4074879	4174879
Aspergillus_fumigatus_IFM_55369	39	38	1	0	scaffold_6	1621998	1721998
Aspergillus_fumigatus_IFM_55369	42	41	1	0	scaffold_4	622673	722673
Aspergillus_fumigatus_IFM_55369	23	20	3	0	scaffold_5	139049	239049
Aspergillus_fumigatus_IFM_55369	49	43	6	0	scaffold_1	4092895	4192895
Aspergillus_fumigatus_IFM_55369	39	38	1	0	scaffold_6	2774968	2874968
Aspergillus_fumigatus_IFM_55369	36	36	0	0	scaffold_6	2895436	2995436
Aspergillus_fumigatus_IFM_55369	44	41	3	0	scaffold_3	1730203	1830203
Aspergillus_fumigatus_IFM_55369	36	36	0	0	scaffold_4	2413532	2513532
Aspergillus_fumigatus_IFM_55369	39	30	9	0	scaffold_6	2151168	2251168
Aspergillus_fumigatus_IFM_55369	35	34	1	0	scaffold_6	1320220	1420220
Aspergillus_fumigatus_IFM_55369	29	28	1	0	scaffold_3	3071496	3171496
Aspergillus_fumigatus_IFM_55369	39	36	3	0	scaffold_7	448360	548360
Aspergillus_fumigatus_IFM_55369	41	38	3	0	scaffold_5	2810853	2910853
Aspergillus_fumigatus_IFM_55369	35	26	9	0	scaffold_3	878968	978968
Aspergillus_fumigatus_IFM_55369	21	4	17	0	scaffold_4	92862	192862
Aspergillus_fumigatus_IFM_55369	38	33	5	0	scaffold_2	3806012	3906012
Aspergillus_fumigatus_IFM_55369	41	37	4	0	scaffold_1	4273388	4373388
Aspergillus_fumigatus_IFM_55369	36	33	3	0	scaffold_6	1180704	1280704
Aspergillus_fumigatus_IFM_55369	28	26	2	0	scaffold_6	1356658	1456658
Aspergillus_fumigatus_IFM_55369	43	11	32	0	scaffold_4	3679350	3779350
Aspergillus_fumigatus_IFM_55369	35	31	4	0	scaffold_6	3161149	3261149
Aspergillus_fumigatus_IFM_55369	43	41	2	0	scaffold_6	2230326	2330326
Aspergillus_fumigatus_IFM_55369	41	41	0	0	scaffold_1	321247	421247
Aspergillus_fumigatus_IFM_55369	35	32	3	0	scaffold_6	3242557	3342557
Aspergillus_fumigatus_IFM_55369	35	31	4	0	scaffold_1	4396047	4496047
Aspergillus_fumigatus_IFM_55369	27	27	0	0	scaffold_6	195851	295851
Aspergillus_fumigatus_IFM_55369	31	27	3	1	scaffold_8	751111	851111
Aspergillus_fumigatus_IFM_55369	34	32	2	0	scaffold_1	830093	930093
Aspergillus_fumigatus_IFM_55369	46	41	5	0	scaffold_3	2471352	2571352
Aspergillus_fumigatus_IFM_55369	41	38	3	0	scaffold_6	1954686	2054686
Aspergillus_fumigatus_IFM_55369	40	36	4	0	scaffold_1	4271630	4371630
Aspergillus_fumigatus_IFM_55369	43	40	3	0	scaffold_8	167964	267964
Aspergillus_fumigatus_IFM_55369	38	37	1	0	scaffold_2	2178266	2278266
Aspergillus_fumigatus_IFM_55369	29	29	0	0	scaffold_1	3356882	3456882
Aspergillus_fumigatus_IFM_55369	33	28	5	0	scaffold_3	2658447	2758447
Aspergillus_fumigatus_IFM_55369	38	38	0	0	scaffold_5	3171123	3271123
Aspergillus_fumigatus_IFM_55369	38	37	1	0	scaffold_3	195256	295256
Aspergillus_fumigatus_IFM_55369	21	21	0	0	scaffold_7	626536	726536
Aspergillus_fumigatus_IFM_55369	37	35	2	0	scaffold_5	901331	1001331
Aspergillus_fumigatus_IFM_55369	32	29	3	0	scaffold_3	1906941	2006941
Aspergillus_fumigatus_IFM_55369	36	34	2	0	scaffold_3	1472313	1572313
Aspergillus_fumigatus_IFM_55369	37	32	5	0	scaffold_2	1366720	1466720
Aspergillus_fumigatus_IFM_55369	37	35	2	0	scaffold_8	966391	1066391
Aspergillus_fumigatus_IFM_55369	38	36	2	0	scaffold_3	3232771	3332771
Aspergillus_fumigatus_IFM_55369	37	34	3	0	scaffold_3	3388374	3488374
Aspergillus_fumigatus_IFM_55369	15	14	1	0	scaffold_6	1123649	1223649
Aspergillus_fumigatus_IFM_55369	41	40	1	0	scaffold_2	2001371	2101371
Aspergillus_fumigatus_IFM_55369	27	26	1	0	scaffold_4	1216130	1316130
Aspergillus_fumigatus_IFM_55369	31	31	0	0	scaffold_4	767853	867853
Aspergillus_fumigatus_IFM_55369	40	38	2	0	scaffold_2	3593540	3693540
Aspergillus_fumigatus_IFM_55369	39	35	4	0	scaffold_6	1911622	2011622
Aspergillus_fumigatus_IFM_55369	38	30	8	0	scaffold_6	2099321	2199321
Aspergillus_fumigatus_IFM_55369	32	30	2	0	scaffold_6	319425	419425
Aspergillus_fumigatus_IFM_55369	42	37	5	0	scaffold_3	3678126	3778126
Aspergillus_fumigatus_IFM_55369	37	33	4	0	scaffold_3	2729571	2829571
Aspergillus_fumigatus_IFM_55369	38	38	0	0	scaffold_4	665545	765545
Aspergillus_fumigatus_IFM_55369	39	35	4	0	scaffold_1	4405800	4505800
Aspergillus_fumigatus_IFM_55369	39	35	4	0	scaffold_1	3952614	4052614
Aspergillus_fumigatus_IFM_55369	37	36	1	0	scaffold_4	646246	746246
Aspergillus_fumigatus_IFM_55369	40	35	5	0	scaffold_8	1378813	1478813
Aspergillus_fumigatus_IFM_55369	43	40	3	0	scaffold_8	1229995	1329995
Aspergillus_fumigatus_IFM_55369	40	33	7	0	scaffold_4	1726506	1826506
Aspergillus_fumigatus_IFM_55369	41	39	2	0	scaffold_4	420791	520791
Aspergillus_fumigatus_IFM_55369	45	38	7	0	scaffold_7	1488988	1588988
Aspergillus_fumigatus_IFM_55369	41	39	2	0	scaffold_5	627214	727214
Aspergillus_fumigatus_IFM_55369	43	37	6	0	scaffold_8	81313	181313
Aspergillus_fumigatus_IFM_55369	32	31	1	0	scaffold_4	2095926	2195926
Aspergillus_fumigatus_IFM_55369	37	36	1	0	scaffold_1	3502010	3602010
Aspergillus_fumigatus_IFM_55369	33	32	1	0	scaffold_3	1560361	1660361
Aspergillus_fumigatus_IFM_55369	38	29	9	0	scaffold_5	2369599	2469599
Aspergillus_fumigatus_IFM_55369	6	5	1	0	scaffold_7	1650433	1750433
Aspergillus_fumigatus_IFM_55369	36	36	0	0	scaffold_6	1475994	1575994
Aspergillus_fumigatus_IFM_55369	36	35	1	0	scaffold_5	1675076	1775076
Aspergillus_fumigatus_IFM_55369	35	34	1	0	scaffold_6	2983792	3083792
Aspergillus_fumigatus_IFM_55369	26	21	5	0	scaffold_6	3445745	3545745
Aspergillus_fumigatus_IFM_55369	35	30	5	0	scaffold_2	3765087	3865087
Aspergillus_fumigatus_IFM_55369	49	42	7	0	scaffold_8	353066	453066
Aspergillus_fumigatus_IFM_55369	12	11	1	0	scaffold_2	1770579	1870579
Aspergillus_fumigatus_IFM_55369	39	34	5	0	scaffold_2	3100007	3200007
Aspergillus_fumigatus_IFM_55369	39	36	3	0	scaffold_4	1697813	1797813
Aspergillus_fumigatus_IFM_55369	38	32	6	0	scaffold_3	2617540	2717540
Aspergillus_fumigatus_IFM_55369	32	29	3	0	scaffold_4	1492279	1592279
Aspergillus_fumigatus_IFM_55369	37	32	5	0	scaffold_3	2795877	2895877
Aspergillus_fumigatus_IFM_55369	21	19	1	1	scaffold_8	775878	875878
Aspergillus_fumigatus_IFM_55369	47	37	10	0	scaffold_2	55789	155789
Aspergillus_fumigatus_IFM_55369	34	33	1	0	scaffold_6	2012679	2112679
Aspergillus_fumigatus_IFM_55369	41	31	10	0	scaffold_2	4037920	4137920
Aspergillus_fumigatus_IFM_55369	30	29	1	0	scaffold_4	826772	926772
Aspergillus_fumigatus_IFM_55369	51	41	10	0	scaffold_4	3833002	3933002
Aspergillus_fumigatus_IFM_55369	39	38	1	0	scaffold_6	1678331	1778331
Aspergillus_fumigatus_IFM_55369	40	35	5	0	scaffold_7	86546	186546
Aspergillus_fumigatus_IFM_55369	35	32	3	0	scaffold_6	582593	682593
Aspergillus_fumigatus_IFM_55369	42	34	8	0	scaffold_4	193347	293347
Aspergillus_fumigatus_IFM_55369	42	23	19	0	scaffold_3	1068998	1168998
Aspergillus_fumigatus_IFM_55369	23	19	4	0	scaffold_5	78620	178620
Aspergillus_fumigatus_IFM_55369	36	30	6	0	scaffold_1	588893	688893
Aspergillus_fumigatus_IFM_55369	36	31	5	0	scaffold_5	2748376	2848376
Aspergillus_fumigatus_IFM_55369	43	40	3	0	scaffold_5	669090	769090
Aspergillus_fumigatus_IFM_55369	39	37	2	0	scaffold_2	2308144	2408144
Aspergillus_fumigatus_IFM_55369	30	30	0	0	scaffold_1	1653276	1753276
Aspergillus_fumigatus_IFM_55369	33	33	0	0	scaffold_2	683779	783779
Aspergillus_fumigatus_IFM_55369	33	32	1	0	scaffold_2	2738630	2838630
Aspergillus_fumigatus_IFM_55369	38	36	2	0	scaffold_4	3009002	3109002
Aspergillus_fumigatus_IFM_55369	41	38	3	0	scaffold_3	2322679	2422679
Aspergillus_fumigatus_IFM_55369	46	42	4	0	scaffold_3	504090	604090
Aspergillus_fumigatus_IFM_55369	19	15	4	0	scaffold_5	55847	155847
Aspergillus_fumigatus_IFM_55369	38	34	4	0	scaffold_2	3132109	3232109
Aspergillus_fumigatus_IFM_55369	36	33	3	0	scaffold_3	2144900	2244900
Aspergillus_fumigatus_IFM_55369	34	29	5	0	scaffold_1	4021392	4121392
Aspergillus_fumigatus_IFM_55369	36	34	2	0	scaffold_1	539395	639395
Aspergillus_fumigatus_IFM_55369	35	33	2	0	scaffold_2	940648	1040648
Aspergillus_fumigatus_IFM_55369	40	35	5	0	scaffold_3	293336	393336
Aspergillus_fumigatus_IFM_55369	38	38	0	0	scaffold_5	3133655	3233655
Aspergillus_fumigatus_IFM_55369	40	38	2	0	scaffold_4	1020820	1120820
Aspergillus_fumigatus_IFM_55369	34	27	7	0	scaffold_2	3305330	3405330
Aspergillus_fumigatus_IFM_55369	34	31	3	0	scaffold_1	3003043	3103043
Aspergillus_fumigatus_IFM_55369	38	34	4	0	scaffold_1	4266891	4366891
Aspergillus_fumigatus_IFM_55369	25	1	24	0	scaffold_4	59718	159718
Aspergillus_fumigatus_IFM_55369	34	28	6	0	scaffold_5	2977623	3077623
Aspergillus_fumigatus_IFM_55369	35	31	4	0	scaffold_6	421347	521347
Aspergillus_fumigatus_IFM_55369	33	25	8	0	scaffold_3	3786144	3886144
Aspergillus_fumigatus_IFM_55369	36	33	3	0	scaffold_5	491534	591534
Aspergillus_fumigatus_IFM_55369	38	37	1	0	scaffold_2	468362	568362
Aspergillus_fumigatus_IFM_55369	39	33	6	0	scaffold_3	863090	963090
Aspergillus_fumigatus_IFM_55369	38	14	24	0	scaffold_4	3725363	3825363
Aspergillus_fumigatus_IFM_55369	38	35	3	0	scaffold_5	1088236	1188236
Aspergillus_fumigatus_IFM_55369	31	30	1	0	scaffold_5	3289428	3389428
Aspergillus_fumigatus_IFM_55369	42	36	6	0	scaffold_2	302631	402631
Aspergillus_fumigatus_IFM_55369	36	32	4	0	scaffold_3	3429312	3529312
Aspergillus_fumigatus_IFM_55369	36	33	3	0	scaffold_7	984328	1084328
Aspergillus_fumigatus_IFM_55369	40	37	3	0	scaffold_3	242492	342492
Aspergillus_fumigatus_IFM_55369	35	35	0	0	scaffold_5	3118962	3218962
Aspergillus_fumigatus_IFM_55369	40	35	5	0	scaffold_8	489285	589285
Aspergillus_fumigatus_IFM_55369	35	32	3	0	scaffold_2	1196401	1296401
Aspergillus_fumigatus_IFM_55369	37	33	4	0	scaffold_1	1271252	1371252
Aspergillus_fumigatus_IFM_55369	42	41	1	0	scaffold_3	3973523	4073523
Aspergillus_fumigatus_IFM_55369	45	42	3	0	scaffold_3	2336037	2436037
Aspergillus_fumigatus_IFM_55369	32	29	3	0	scaffold_6	259471	359471
Aspergillus_fumigatus_IFM_55369	45	42	3	0	scaffold_2	4405893	4505893
Aspergillus_fumigatus_IFM_55369	38	36	2	0	scaffold_6	1201105	1301105
Aspergillus_fumigatus_IFM_55369	37	31	6	0	scaffold_1	441286	541286
Aspergillus_fumigatus_IFM_55369	36	27	9	0	scaffold_3	836990	936990
Aspergillus_fumigatus_IFM_55369	37	36	1	0	scaffold_1	2420879	2520879
Aspergillus_fumigatus_IFM_55369	39	38	1	0	scaffold_4	469585	569585
Aspergillus_fumigatus_IFM_55369	44	42	2	0	scaffold_5	3561156	3661156
Aspergillus_fumigatus_IFM_55369	34	32	2	0	scaffold_4	1614677	1714677
Aspergillus_fumigatus_IFM_55369	37	29	8	0	scaffold_2	3362472	3462472
Aspergillus_fumigatus_IFM_55369	39	32	7	0	scaffold_8	245642	345642
Aspergillus_fumigatus_IFM_55369	41	41	0	0	scaffold_6	1609007	1709007
Aspergillus_fumigatus_IFM_55369	35	33	2	0	scaffold_5	921521	1021521
Aspergillus_fumigatus_IFM_55369	43	41	2	0	scaffold_6	724723	824723
Aspergillus_fumigatus_IFM_55369	33	30	3	0	scaffold_1	3616529	3716529
Aspergillus_fumigatus_IFM_55369	35	31	4	0	scaffold_1	4356824	4456824
Aspergillus_fumigatus_IFM_55369	38	35	3	0	scaffold_5	811852	911852
Aspergillus_fumigatus_IFM_55369	38	35	3	0	scaffold_6	1199561	1299561
Aspergillus_fumigatus_IFM_55369	32	15	17	0	scaffold_3	665516	765516
Aspergillus_fumigatus_IFM_55369	29	26	3	0	scaffold_5	1489896	1589896
Aspergillus_fumigatus_IFM_55369	42	34	8	0	scaffold_5	2498225	2598225
Aspergillus_fumigatus_IFM_55369	38	35	3	0	scaffold_5	1416076	1516076
Aspergillus_fumigatus_IFM_55369	30	27	3	0	scaffold_4	2341228	2441228
Aspergillus_fumigatus_IFM_55369	36	36	0	0	scaffold_2	620823	720823
Aspergillus_fumigatus_IFM_55369	40	39	1	0	scaffold_7	925485	1025485
Aspergillus_fumigatus_IFM_55369	44	40	4	0	scaffold_3	2453621	2553621
Aspergillus_fumigatus_IFM_55369	39	34	5	0	scaffold_2	3104546	3204546
Aspergillus_fumigatus_IFM_55369	31	30	1	0	scaffold_1	1070390	1170390
Aspergillus_fumigatus_IFM_55369	47	41	6	0	scaffold_4	3950926	4050926
Aspergillus_fumigatus_IFM_55369	42	39	3	0	scaffold_2	4412622	4512622
Aspergillus_fumigatus_IFM_55369	34	21	13	0	scaffold_5	3673933	3773933
Aspergillus_fumigatus_IFM_55369	37	35	2	0	scaffold_2	2123634	2223634
Aspergillus_fumigatus_IFM_55369	45	41	4	0	scaffold_1	4112073	4212073
Aspergillus_fumigatus_IFM_55369	35	34	1	0	scaffold_1	3096647	3196647
Aspergillus_fumigatus_IFM_55369	37	35	2	0	scaffold_6	805153	905153
Aspergillus_fumigatus_IFM_55369	43	37	6	0	scaffold_8	72234	172234
Aspergillus_fumigatus_IFM_55369	32	31	1	0	scaffold_6	2962567	3062567
Aspergillus_fumigatus_IFM_55369	27	25	2	0	scaffold_6	348345	448345
Aspergillus_fumigatus_IFM_55369	35	34	1	0	scaffold_4	2869194	2969194
Aspergillus_fumigatus_IFM_55369	27	25	2	0	scaffold_5	307452	407452
Aspergillus_fumigatus_IFM_55369	38	18	20	0	scaffold_3	798366	898366
Aspergillus_fumigatus_IFM_55369	39	35	4	0	scaffold_1	3472802	3572802
Aspergillus_fumigatus_IFM_55369	35	35	0	0	scaffold_4	3217726	3317726
Aspergillus_fumigatus_IFM_55369	36	26	10	0	scaffold_2	4209186	4309186
Aspergillus_fumigatus_IFM_55369	35	32	3	0	scaffold_4	2547333	2647333
Aspergillus_fumigatus_IFM_55369	41	40	1	0	scaffold_2	440517	540517
Aspergillus_fumigatus_IFM_55369	38	29	9	0	scaffold_5	2906624	3006624
Aspergillus_fumigatus_IFM_55369	39	36	3	0	scaffold_1	3558909	3658909
Aspergillus_fumigatus_IFM_55369	33	30	3	0	scaffold_3	1904609	2004609
Aspergillus_fumigatus_IFM_55369	21	17	4	0	scaffold_5	60002	160002
Aspergillus_fumigatus_IFM_55369	48	40	8	0	scaffold_4	3899604	3999604
Aspergillus_fumigatus_IFM_55369	16	14	2	0	scaffold_1	1884944	1984944
Aspergillus_fumigatus_IFM_55369	32	30	2	0	scaffold_6	317420	417420
Aspergillus_fumigatus_IFM_55369	38	36	2	0	scaffold_4	494369	594369
Aspergillus_fumigatus_IFM_55369	42	39	3	0	scaffold_4	985735	1085735
Aspergillus_fumigatus_IFM_55369	28	7	21	0	scaffold_3	595209	695209
Aspergillus_fumigatus_IFM_55369	30	28	2	0	scaffold_2	2610958	2710958
Aspergillus_fumigatus_IFM_55369	27	22	5	0	scaffold_5	213397	313397
Aspergillus_fumigatus_IFM_55369	14	13	1	0	scaffold_4	1255752	1355752
Aspergillus_fumigatus_IFM_55369	36	32	4	0	scaffold_6	3161734	3261734
Aspergillus_fumigatus_IFM_55369	38	30	8	0	scaffold_6	2085526	2185526
Aspergillus_fumigatus_IFM_55369	39	32	7	0	scaffold_8	1532466	1632466
Aspergillus_fumigatus_IFM_55369	35	34	1	0	scaffold_4	2934623	3034623
Aspergillus_fumigatus_IFM_55369	6	5	1	0	scaffold_6	1108226	1208226
Aspergillus_fumigatus_IFM_55369	25	21	4	0	scaffold_5	1956580	2056580
Aspergillus_fumigatus_IFM_55369	38	30	8	0	scaffold_6	3533984	3633984
Aspergillus_fumigatus_IFM_55369	35	33	2	0	scaffold_1	2820826	2920826
Aspergillus_fumigatus_IFM_55369	24	23	1	0	scaffold_1	1837889	1937889
Aspergillus_fumigatus_IFM_55369	37	36	1	0	scaffold_1	2841424	2941424
Aspergillus_fumigatus_IFM_55369	29	29	0	0	scaffold_1	3347489	3447489
Aspergillus_fumigatus_IFM_55369	32	30	2	0	scaffold_2	1215273	1315273
Aspergillus_fumigatus_IFM_55369	33	31	2	0	scaffold_2	3540902	3640902
Aspergillus_fumigatus_IFM_55369	40	38	2	0	scaffold_2	3597595	3697595
Aspergillus_fumigatus_IFM_55369	39	37	2	0	scaffold_2	3176558	3276558
Aspergillus_fumigatus_IFM_55369	34	31	3	0	scaffold_2	1537348	1637348
Aspergillus_fumigatus_IFM_55369	39	37	2	0	scaffold_7	816545	916545
Aspergillus_fumigatus_IFM_55369	41	35	6	0	scaffold_2	257597	357597
Aspergillus_fumigatus_IFM_55369	38	36	2	0	scaffold_3	3233030	3333030
Aspergillus_fumigatus_IFM_55369	37	29	8	0	scaffold_5	2324336	2424336
Aspergillus_fumigatus_IFM_55369	38	38	0	0	scaffold_5	3615763	3715763
Aspergillus_fumigatus_IFM_55369	37	21	16	0	scaffold_3	814290	914290
Aspergillus_fumigatus_IFM_55369	30	27	3	0	scaffold_7	786694	886694
Aspergillus_fumigatus_IFM_55369	35	31	4	0	scaffold_2	3251678	3351678
Aspergillus_fumigatus_IFM_55369	43	38	5	0	scaffold_8	129874	229874
Aspergillus_fumigatus_IFM_55369	37	33	4	0	scaffold_1	496121	596121
Aspergillus_fumigatus_IFM_55369	38	36	2	0	scaffold_8	1037948	1137948
Aspergillus_fumigatus_IFM_55369	37	33	4	0	scaffold_1	4410048	4510048
Aspergillus_fumigatus_IFM_55369	42	40	2	0	scaffold_3	1671582	1771582
Aspergillus_fumigatus_IFM_55369	43	40	3	0	scaffold_3	1714144	1814144
Aspergillus_fumigatus_IFM_55369	38	37	1	0	scaffold_6	1310305	1410305
Aspergillus_fumigatus_IFM_55369	43	36	7	0	scaffold_7	174023	274023
Aspergillus_fumigatus_IFM_55369	43	38	5	0	scaffold_3	3691226	3791226
Aspergillus_fumigatus_IFM_55369	44	37	7	0	scaffold_8	282236	382236
Aspergillus_fumigatus_IFM_55369	30	27	3	0	scaffold_8	873488	973488
Aspergillus_fumigatus_IFM_55369	23	7	16	0	scaffold_4	101895	201895
Aspergillus_fumigatus_IFM_55369	36	33	3	0	scaffold_6	3200480	3300480
Aspergillus_fumigatus_IFM_55369	35	33	2	0	scaffold_1	815791	915791
Aspergillus_fumigatus_IFM_55369	40	37	3	0	scaffold_5	1609939	1709939
Aspergillus_fumigatus_IFM_55369	33	33	0	0	scaffold_1	777026	877026
Aspergillus_fumigatus_IFM_55369	34	27	7	0	scaffold_2	3322115	3422115
Aspergillus_fumigatus_IFM_55369	37	37	0	0	scaffold_4	669255	769255
Aspergillus_fumigatus_IFM_55369	46	43	3	0	scaffold_3	113153	213153
Aspergillus_fumigatus_IFM_55369	36	36	0	0	scaffold_2	534423	634423
Aspergillus_fumigatus_IFM_55369	41	17	24	0	scaffold_2	4077100	4177100
Aspergillus_fumigatus_IFM_55369	36	33	3	0	scaffold_2	1522360	1622360
Aspergillus_fumigatus_IFM_55369	40	38	2	0	scaffold_6	906085	1006085
Aspergillus_fumigatus_IFM_55369	44	41	3	0	scaffold_3	1754983	1854983
Aspergillus_fumigatus_IFM_55369	37	34	3	0	scaffold_1	386579	486579
Aspergillus_fumigatus_IFM_55369	48	40	8	0	scaffold_4	3898605	3998605
Aspergillus_fumigatus_IFM_55369	47	45	2	0	scaffold_3	4076113	4176113
Aspergillus_fumigatus_IFM_55369	45	44	1	0	scaffold_4	1115598	1215598
Aspergillus_fumigatus_IFM_55369	35	33	2	0	scaffold_1	2827281	2927281
Aspergillus_fumigatus_IFM_55369	31	31	0	0	scaffold_2	714887	814887
Aspergillus_fumigatus_IFM_55369	29	22	7	0	scaffold_3	1849172	1949172
Aspergillus_fumigatus_IFM_55369	22	21	1	0	scaffold_6	1136318	1236318
Aspergillus_fumigatus_IFM_55369	33	31	2	0	scaffold_2	878102	978102
Aspergillus_fumigatus_IFM_55369	39	35	2	2	scaffold_6	3026825	3126825
Aspergillus_fumigatus_IFM_55369	41	40	1	0	scaffold_3	3968155	4068155
Aspergillus_fumigatus_IFM_55369	13	11	2	0	scaffold_7	1630846	1730846
