STRAIN	TOTAL	CORE	ACCESSORY	SINGLETON	CHROM	START	END
Aspergillus_fumigatus_1F1SW_F4	18	16	2	0	scaffold_4	323997	373997
Aspergillus_fumigatus_1F1SW_F4	18	16	2	0	scaffold_3	3693284	3743284
Aspergillus_fumigatus_1F1SW_F4	20	18	2	0	scaffold_3	2413801	2463801
Aspergillus_fumigatus_1F1SW_F4	17	15	2	0	scaffold_3	2381330	2431330
Aspergillus_fumigatus_1F1SW_F4	19	17	2	0	scaffold_6	1138869	1188869
Aspergillus_fumigatus_1F1SW_F4	18	18	0	0	scaffold_6	1529971	1579971
Aspergillus_fumigatus_1F1SW_F4	18	17	1	0	scaffold_2	3223549	3273549
Aspergillus_fumigatus_1F1SW_F4	17	15	2	0	scaffold_2	2660243	2710243
Aspergillus_fumigatus_1F1SW_F4	21	18	3	0	scaffold_7	1128378	1178378
Aspergillus_fumigatus_1F1SW_F4	16	15	1	0	scaffold_2	3741150	3791150
Aspergillus_fumigatus_1F1SW_F4	18	15	3	0	scaffold_2	1526400	1576400
Aspergillus_fumigatus_1F1SW_F4	14	12	2	0	scaffold_7	835284	885284
Aspergillus_fumigatus_1F1SW_F4	22	4	18	0	scaffold_5	658997	708997
Aspergillus_fumigatus_1F1SW_F4	17	17	0	0	scaffold_1	849527	899527
Aspergillus_fumigatus_1F1SW_F4	22	20	2	0	scaffold_5	390310	440310
Aspergillus_fumigatus_1F1SW_F4	16	14	2	0	scaffold_2	955838	1005838
Aspergillus_fumigatus_1F1SW_F4	19	17	2	0	scaffold_3	1508506	1558506
Aspergillus_fumigatus_1F1SW_F4	18	18	0	0	scaffold_6	2409709	2459709
Aspergillus_fumigatus_1F1SW_F4	21	18	3	0	scaffold_6	1349419	1399419
Aspergillus_fumigatus_1F1SW_F4	22	19	3	0	scaffold_4	3663487	3713487
Aspergillus_fumigatus_1F1SW_F4	19	17	2	0	scaffold_2	1223653	1273653
Aspergillus_fumigatus_1F1SW_F4	22	22	0	0	scaffold_6	2742630	2792630
Aspergillus_fumigatus_1F1SW_F4	19	16	3	0	scaffold_2	3064641	3114641
Aspergillus_fumigatus_1F1SW_F4	3	3	0	0	scaffold_5	134664	184664
Aspergillus_fumigatus_1F1SW_F4	19	17	2	0	scaffold_6	1508145	1558145
Aspergillus_fumigatus_1F1SW_F4	14	13	1	0	scaffold_5	1427518	1477518
Aspergillus_fumigatus_1F1SW_F4	13	12	1	0	scaffold_3	1556303	1606303
Aspergillus_fumigatus_1F1SW_F4	19	17	2	0	scaffold_2	1511829	1561829
Aspergillus_fumigatus_1F1SW_F4	23	18	5	0	scaffold_1	3773802	3823802
Aspergillus_fumigatus_1F1SW_F4	17	17	0	0	scaffold_6	378684	428684
Aspergillus_fumigatus_1F1SW_F4	21	19	2	0	scaffold_5	401418	451418
Aspergillus_fumigatus_1F1SW_F4	20	19	1	0	scaffold_6	2268784	2318784
Aspergillus_fumigatus_1F1SW_F4	17	16	1	0	scaffold_2	4387918	4437918
Aspergillus_fumigatus_1F1SW_F4	19	19	0	0	scaffold_6	803895	853895
Aspergillus_fumigatus_1F1SW_F4	18	16	2	0	scaffold_1	3043897	3093897
Aspergillus_fumigatus_1F1SW_F4	22	21	1	0	scaffold_2	270743	320743
Aspergillus_fumigatus_1F1SW_F4	20	17	3	0	scaffold_5	315860	365860
Aspergillus_fumigatus_1F1SW_F4	23	23	0	0	scaffold_3	1210078	1260078
Aspergillus_fumigatus_1F1SW_F4	15	13	2	0	scaffold_4	3414169	3464169
Aspergillus_fumigatus_1F1SW_F4	17	16	1	0	scaffold_8	488456	538456
Aspergillus_fumigatus_1F1SW_F4	22	20	2	0	scaffold_5	391574	441574
Aspergillus_fumigatus_1F1SW_F4	26	19	7	0	scaffold_1	85087	135087
Aspergillus_fumigatus_1F1SW_F4	17	15	2	0	scaffold_4	1239887	1289887
Aspergillus_fumigatus_1F1SW_F4	21	21	0	0	scaffold_3	3924311	3974311
Aspergillus_fumigatus_1F1SW_F4	20	17	3	0	scaffold_2	3577370	3627370
Aspergillus_fumigatus_1F1SW_F4	24	21	2	1	scaffold_7	1361198	1411198
Aspergillus_fumigatus_1F1SW_F4	22	20	2	0	scaffold_2	1546413	1596413
Aspergillus_fumigatus_1F1SW_F4	29	28	1	0	scaffold_5	3745552	3795552
Aspergillus_fumigatus_1F1SW_F4	19	18	1	0	scaffold_4	2261707	2311707
Aspergillus_fumigatus_1F1SW_F4	18	18	0	0	scaffold_8	1470191	1520191
Aspergillus_fumigatus_1F1SW_F4	19	19	0	0	scaffold_2	389581	439581
Aspergillus_fumigatus_1F1SW_F4	18	16	2	0	scaffold_1	3081558	3131558
Aspergillus_fumigatus_1F1SW_F4	5	4	1	0	scaffold_5	128043	178043
Aspergillus_fumigatus_1F1SW_F4	16	16	0	0	scaffold_1	1134425	1184425
Aspergillus_fumigatus_1F1SW_F4	18	17	1	0	scaffold_6	14143	64143
Aspergillus_fumigatus_1F1SW_F4	21	19	2	0	scaffold_3	1679698	1729698
Aspergillus_fumigatus_1F1SW_F4	12	11	1	0	scaffold_1	2657577	2707577
Aspergillus_fumigatus_1F1SW_F4	15	14	1	0	scaffold_3	3750661	3800661
Aspergillus_fumigatus_1F1SW_F4	18	17	1	0	scaffold_5	2993586	3043586
Aspergillus_fumigatus_1F1SW_F4	17	16	1	0	scaffold_6	557904	607904
Aspergillus_fumigatus_1F1SW_F4	19	17	2	0	scaffold_3	3159984	3209984
Aspergillus_fumigatus_1F1SW_F4	18	14	4	0	scaffold_1	3974069	4024069
Aspergillus_fumigatus_1F1SW_F4	21	17	4	0	scaffold_3	3464915	3514915
Aspergillus_fumigatus_1F1SW_F4	20	19	1	0	scaffold_8	1478811	1528811
Aspergillus_fumigatus_1F1SW_F4	17	12	5	0	scaffold_5	701991	751991
Aspergillus_fumigatus_1F1SW_F4	19	18	1	0	scaffold_6	1567736	1617736
Aspergillus_fumigatus_1F1SW_F4	18	18	0	0	scaffold_2	1883105	1933105
Aspergillus_fumigatus_1F1SW_F4	19	18	1	0	scaffold_2	2118821	2168821
Aspergillus_fumigatus_1F1SW_F4	15	9	6	0	scaffold_5	3446531	3496531
Aspergillus_fumigatus_1F1SW_F4	22	18	4	0	scaffold_3	911683	961683
Aspergillus_fumigatus_1F1SW_F4	20	20	0	0	scaffold_3	3933173	3983173
Aspergillus_fumigatus_1F1SW_F4	23	21	2	0	scaffold_8	42458	92458
Aspergillus_fumigatus_1F1SW_F4	23	21	2	0	scaffold_4	50033	100033
Aspergillus_fumigatus_1F1SW_F4	21	18	2	1	scaffold_7	1352131	1402131
Aspergillus_fumigatus_1F1SW_F4	21	19	2	0	scaffold_1	1799895	1849895
Aspergillus_fumigatus_1F1SW_F4	17	15	2	0	scaffold_1	3516620	3566620
Aspergillus_fumigatus_1F1SW_F4	18	11	7	0	scaffold_3	2702632	2752632
Aspergillus_fumigatus_1F1SW_F4	15	15	0	0	scaffold_5	1505684	1555684
Aspergillus_fumigatus_1F1SW_F4	16	16	0	0	scaffold_6	352859	402859
Aspergillus_fumigatus_1F1SW_F4	23	19	4	0	scaffold_1	2944635	2994635
Aspergillus_fumigatus_1F1SW_F4	19	17	2	0	scaffold_5	1464483	1514483
Aspergillus_fumigatus_1F1SW_F4	14	13	1	0	scaffold_4	1849894	1899894
Aspergillus_fumigatus_1F1SW_F4	16	16	0	0	scaffold_2	3865225	3915225
Aspergillus_fumigatus_1F1SW_F4	21	20	1	0	scaffold_6	3393663	3443663
Aspergillus_fumigatus_1F1SW_F4	14	14	0	0	scaffold_8	607263	657263
Aspergillus_fumigatus_1F1SW_F4	10	4	6	0	scaffold_4	3769467	3819467
Aspergillus_fumigatus_1F1SW_F4	18	16	2	0	scaffold_2	3141009	3191009
Aspergillus_fumigatus_1F1SW_F4	18	16	2	0	scaffold_3	2402436	2452436
Aspergillus_fumigatus_1F1SW_F4	18	16	2	0	scaffold_8	890885	940885
Aspergillus_fumigatus_1F1SW_F4	15	14	1	0	scaffold_1	1773586	1823586
Aspergillus_fumigatus_1F1SW_F4	18	13	5	0	scaffold_1	3134032	3184032
Aspergillus_fumigatus_1F1SW_F4	22	20	2	0	scaffold_1	34450	84450
Aspergillus_fumigatus_1F1SW_F4	17	17	0	0	scaffold_6	1519430	1569430
Aspergillus_fumigatus_1F1SW_F4	7	4	3	0	scaffold_4	3727202	3777202
Aspergillus_fumigatus_1F1SW_F4	30	24	6	0	scaffold_4	3592045	3642045
Aspergillus_fumigatus_1F1SW_F4	19	17	2	0	scaffold_2	3757487	3807487
Aspergillus_fumigatus_1F1SW_F4	18	16	2	0	scaffold_6	1127714	1177714
Aspergillus_fumigatus_1F1SW_F4	21	20	1	0	scaffold_6	1551046	1601046
Aspergillus_fumigatus_1F1SW_F4	17	17	0	0	scaffold_6	794780	844780
Aspergillus_fumigatus_1F1SW_F4	7	4	3	0	scaffold_2	713216	763216
Aspergillus_fumigatus_1F1SW_F4	21	20	1	0	scaffold_7	1671604	1721604
Aspergillus_fumigatus_1F1SW_F4	16	15	1	0	scaffold_7	1447187	1497187
Aspergillus_fumigatus_1F1SW_F4	5	5	0	0	scaffold_5	1038292	1088292
Aspergillus_fumigatus_1F1SW_F4	20	18	2	0	scaffold_6	1490320	1540320
Aspergillus_fumigatus_1F1SW_F4	19	19	0	0	scaffold_2	1783354	1833354
Aspergillus_fumigatus_1F1SW_F4	19	17	2	0	scaffold_2	3137579	3187579
Aspergillus_fumigatus_1F1SW_F4	17	16	1	0	scaffold_3	2070185	2120185
Aspergillus_fumigatus_1F1SW_F4	16	14	2	0	scaffold_1	3012602	3062602
Aspergillus_fumigatus_1F1SW_F4	19	14	5	0	scaffold_5	954442	1004442
Aspergillus_fumigatus_1F1SW_F4	15	8	7	0	scaffold_5	2585629	2635629
Aspergillus_fumigatus_1F1SW_F4	17	15	2	0	scaffold_3	3789889	3839889
Aspergillus_fumigatus_1F1SW_F4	19	16	3	0	scaffold_6	1470084	1520084
Aspergillus_fumigatus_1F1SW_F4	20	19	1	0	scaffold_8	859418	909418
Aspergillus_fumigatus_1F1SW_F4	20	20	0	0	scaffold_1	2725786	2775786
Aspergillus_fumigatus_1F1SW_F4	22	21	1	0	scaffold_5	2070040	2120040
Aspergillus_fumigatus_1F1SW_F4	20	18	2	0	scaffold_1	1817409	1867409
Aspergillus_fumigatus_1F1SW_F4	25	20	5	0	scaffold_8	157608	207608
Aspergillus_fumigatus_1F1SW_F4	17	11	6	0	scaffold_5	1966837	2016837
Aspergillus_fumigatus_1F1SW_F4	15	14	1	0	scaffold_5	1177000	1227000
Aspergillus_fumigatus_1F1SW_F4	15	12	3	0	scaffold_1	1094890	1144890
Aspergillus_fumigatus_1F1SW_F4	15	14	1	0	scaffold_6	1789706	1839706
Aspergillus_fumigatus_1F1SW_F4	18	16	2	0	scaffold_2	4117584	4167584
Aspergillus_fumigatus_1F1SW_F4	25	22	3	0	scaffold_1	4510594	4560594
Aspergillus_fumigatus_1F1SW_F4	15	12	3	0	scaffold_3	1824404	1874404
Aspergillus_fumigatus_1F1SW_F4	19	17	2	0	scaffold_7	1021059	1071059
Aspergillus_fumigatus_1F1SW_F4	17	16	1	0	scaffold_6	1257075	1307075
Aspergillus_fumigatus_1F1SW_F4	21	20	1	0	scaffold_6	1546362	1596362
Aspergillus_fumigatus_1F1SW_F4	20	17	3	0	scaffold_1	4007795	4057795
Aspergillus_fumigatus_1F1SW_F4	20	18	2	0	scaffold_2	2764602	2814602
Aspergillus_fumigatus_1F1SW_F4	21	19	2	0	scaffold_2	1543697	1593697
Aspergillus_fumigatus_1F1SW_F4	9	8	1	0	scaffold_3	2767503	2817503
Aspergillus_fumigatus_1F1SW_F4	20	18	2	0	scaffold_1	222391	272391
Aspergillus_fumigatus_1F1SW_F4	19	18	1	0	scaffold_1	1865710	1915710
Aspergillus_fumigatus_1F1SW_F4	21	21	0	0	scaffold_2	4006876	4056876
Aspergillus_fumigatus_1F1SW_F4	17	15	2	0	scaffold_2	675255	725255
Aspergillus_fumigatus_1F1SW_F4	21	20	1	0	scaffold_1	529456	579456
Aspergillus_fumigatus_1F1SW_F4	18	18	0	0	scaffold_1	1722145	1772145
Aspergillus_fumigatus_1F1SW_F4	18	18	0	0	scaffold_6	2701707	2751707
Aspergillus_fumigatus_1F1SW_F4	18	16	2	0	scaffold_4	322456	372456
Aspergillus_fumigatus_1F1SW_F4	7	6	1	0	scaffold_3	176193	226193
Aspergillus_fumigatus_1F1SW_F4	21	20	1	0	scaffold_6	1271771	1321771
Aspergillus_fumigatus_1F1SW_F4	13	13	0	0	scaffold_2	2941912	2991912
Aspergillus_fumigatus_1F1SW_F4	21	4	17	0	scaffold_5	658022	708022
Aspergillus_fumigatus_1F1SW_F4	19	16	3	0	scaffold_4	2373423	2423423
Aspergillus_fumigatus_1F1SW_F4	7	7	0	0	scaffold_6	917095	967095
Aspergillus_fumigatus_1F1SW_F4	14	14	0	0	scaffold_6	398617	448617
Aspergillus_fumigatus_1F1SW_F4	22	20	2	0	scaffold_4	672742	722742
Aspergillus_fumigatus_1F1SW_F4	17	16	1	0	scaffold_6	3492765	3542765
Aspergillus_fumigatus_1F1SW_F4	13	13	0	0	scaffold_3	2253344	2303344
Aspergillus_fumigatus_1F1SW_F4	18	18	0	0	scaffold_5	2822670	2872670
Aspergillus_fumigatus_1F1SW_F4	18	17	1	0	scaffold_4	2255101	2305101
Aspergillus_fumigatus_1F1SW_F4	23	18	5	0	scaffold_8	1299429	1349429
Aspergillus_fumigatus_1F1SW_F4	20	20	0	0	scaffold_2	1772535	1822535
Aspergillus_fumigatus_1F1SW_F4	15	15	0	0	scaffold_2	3462990	3512990
Aspergillus_fumigatus_1F1SW_F4	21	16	5	0	scaffold_6	2951376	3001376
Aspergillus_fumigatus_1F1SW_F4	17	17	0	0	scaffold_1	1751772	1801772
Aspergillus_fumigatus_1F1SW_F4	16	16	0	0	scaffold_4	1028679	1078679
Aspergillus_fumigatus_1F1SW_F4	22	21	1	0	scaffold_4	2056788	2106788
Aspergillus_fumigatus_1F1SW_F4	19	18	1	0	scaffold_2	1764640	1814640
Aspergillus_fumigatus_1F1SW_F4	16	15	1	0	scaffold_5	1409669	1459669
Aspergillus_fumigatus_1F1SW_F4	21	20	1	0	scaffold_4	2498858	2548858
Aspergillus_fumigatus_1F1SW_F4	17	17	0	0	scaffold_2	3838969	3888969
Aspergillus_fumigatus_1F1SW_F4	16	16	0	0	scaffold_2	3468069	3518069
Aspergillus_fumigatus_1F1SW_F4	19	17	2	0	scaffold_6	1320470	1370470
Aspergillus_fumigatus_1F1SW_F4	19	17	2	0	scaffold_3	2826269	2876269
Aspergillus_fumigatus_1F1SW_F4	19	17	2	0	scaffold_1	2134392	2184392
Aspergillus_fumigatus_1F1SW_F4	19	17	2	0	scaffold_4	3423285	3473285
Aspergillus_fumigatus_1F1SW_F4	14	14	0	0	scaffold_2	1173510	1223510
Aspergillus_fumigatus_1F1SW_F4	20	17	3	0	scaffold_8	348187	398187
Aspergillus_fumigatus_1F1SW_F4	18	18	0	0	scaffold_6	2669818	2719818
Aspergillus_fumigatus_1F1SW_F4	20	18	2	0	scaffold_5	3695613	3745613
Aspergillus_fumigatus_1F1SW_F4	17	17	0	0	scaffold_5	1834966	1884966
Aspergillus_fumigatus_1F1SW_F4	21	18	3	0	scaffold_4	209804	259804
Aspergillus_fumigatus_1F1SW_F4	13	12	1	0	scaffold_8	474616	524616
Aspergillus_fumigatus_1F1SW_F4	6	5	1	0	scaffold_8	659849	709849
Aspergillus_fumigatus_1F1SW_F4	16	14	2	0	scaffold_6	3487997	3537997
Aspergillus_fumigatus_1F1SW_F4	17	17	0	0	scaffold_6	788669	838669
Aspergillus_fumigatus_1F1SW_F4	24	22	2	0	scaffold_2	2233951	2283951
Aspergillus_fumigatus_1F1SW_F4	18	17	1	0	scaffold_3	1334335	1384335
Aspergillus_fumigatus_1F1SW_F4	21	19	2	0	scaffold_3	3167272	3217272
Aspergillus_fumigatus_1F1SW_F4	16	16	0	0	scaffold_1	1295447	1345447
Aspergillus_fumigatus_1F1SW_F4	7	3	4	0	scaffold_3	25355	75355
Aspergillus_fumigatus_1F1SW_F4	21	19	2	0	scaffold_2	2808362	2858362
Aspergillus_fumigatus_1F1SW_F4	19	18	1	0	scaffold_5	2939322	2989322
Aspergillus_fumigatus_1F1SW_F4	17	15	2	0	scaffold_8	371871	421871
Aspergillus_fumigatus_1F1SW_F4	2	2	0	0	scaffold_2	1997558	2047558
Aspergillus_fumigatus_1F1SW_F4	20	20	0	0	scaffold_8	928384	978384
Aspergillus_fumigatus_1F1SW_F4	4	4	0	0	scaffold_3	1580310	1630310
Aspergillus_fumigatus_1F1SW_F4	27	25	2	0	scaffold_4	690974	740974
Aspergillus_fumigatus_1F1SW_F4	15	15	0	0	scaffold_2	4410773	4460773
Aspergillus_fumigatus_1F1SW_F4	19	17	2	0	scaffold_5	1448890	1498890
Aspergillus_fumigatus_1F1SW_F4	23	22	1	0	scaffold_3	1202429	1252429
Aspergillus_fumigatus_1F1SW_F4	20	20	0	0	scaffold_6	2506588	2556588
Aspergillus_fumigatus_1F1SW_F4	21	19	2	0	scaffold_3	1420906	1470906
Aspergillus_fumigatus_1F1SW_F4	16	14	2	0	scaffold_7	1551983	1601983
Aspergillus_fumigatus_1F1SW_F4	16	16	0	0	scaffold_3	1764879	1814879
Aspergillus_fumigatus_1F1SW_F4	20	19	1	0	scaffold_1	541222	591222
Aspergillus_fumigatus_1F1SW_F4	19	18	1	0	scaffold_2	3236118	3286118
Aspergillus_fumigatus_1F1SW_F4	18	16	2	0	scaffold_1	3065118	3115118
Aspergillus_fumigatus_1F1SW_F4	19	18	1	0	scaffold_5	2851308	2901308
Aspergillus_fumigatus_1F1SW_F4	22	18	4	0	scaffold_1	3630871	3680871
Aspergillus_fumigatus_1F1SW_F4	24	20	4	0	scaffold_5	3378930	3428930
Aspergillus_fumigatus_1F1SW_F4	21	19	2	0	scaffold_3	791923	841923
Aspergillus_fumigatus_1F1SW_F4	18	17	1	0	scaffold_1	1059752	1109752
Aspergillus_fumigatus_1F1SW_F4	18	17	1	0	scaffold_2	3152089	3202089
Aspergillus_fumigatus_1F1SW_F4	19	17	2	0	scaffold_2	1516380	1566380
Aspergillus_fumigatus_1F1SW_F4	18	15	3	0	scaffold_7	1108033	1158033
Aspergillus_fumigatus_1F1SW_F4	22	20	2	0	scaffold_1	3542712	3592712
Aspergillus_fumigatus_1F1SW_F4	18	18	0	0	scaffold_1	2155558	2205558
Aspergillus_fumigatus_1F1SW_F4	16	15	1	0	scaffold_3	2055411	2105411
Aspergillus_fumigatus_1F1SW_F4	24	20	4	0	scaffold_7	1743421	1793421
Aspergillus_fumigatus_1F1SW_F4	16	16	0	0	scaffold_1	1295737	1345737
Aspergillus_fumigatus_1F1SW_F4	21	19	2	0	scaffold_3	3167361	3217361
Aspergillus_fumigatus_1F1SW_F4	16	15	1	0	scaffold_2	3898291	3948291
Aspergillus_fumigatus_1F1SW_F4	7	5	2	0	scaffold_2	720373	770373
Aspergillus_fumigatus_1F1SW_F4	20	15	5	0	scaffold_1	186100	236100
Aspergillus_fumigatus_1F1SW_F4	19	19	0	0	scaffold_7	792555	842555
Aspergillus_fumigatus_1F1SW_F4	18	18	0	0	scaffold_5	3607440	3657440
Aspergillus_fumigatus_1F1SW_F4	27	20	7	0	scaffold_1	3945166	3995166
Aspergillus_fumigatus_1F1SW_F4	19	18	1	0	scaffold_6	105661	155661
Aspergillus_fumigatus_1F1SW_F4	16	15	1	0	scaffold_6	1047961	1097961
Aspergillus_fumigatus_1F1SW_F4	19	15	4	0	scaffold_2	2686140	2736140
Aspergillus_fumigatus_1F1SW_F4	19	19	0	0	scaffold_2	4030711	4080711
Aspergillus_fumigatus_1F1SW_F4	17	15	2	0	scaffold_6	1122943	1172943
Aspergillus_fumigatus_1F1SW_F4	23	22	1	0	scaffold_2	2176999	2226999
Aspergillus_fumigatus_1F1SW_F4	21	20	1	0	scaffold_3	1742912	1792912
Aspergillus_fumigatus_1F1SW_F4	23	20	3	0	scaffold_6	2171746	2221746
Aspergillus_fumigatus_1F1SW_F4	23	21	2	0	scaffold_1	24045	74045
Aspergillus_fumigatus_1F1SW_F4	20	19	1	0	scaffold_1	535051	585051
Aspergillus_fumigatus_1F1SW_F4	17	16	1	0	scaffold_4	1681536	1731536
Aspergillus_fumigatus_1F1SW_F4	13	12	1	0	scaffold_2	1195182	1245182
Aspergillus_fumigatus_1F1SW_F4	18	18	0	0	scaffold_1	2038308	2088308
Aspergillus_fumigatus_1F1SW_F4	21	18	3	0	scaffold_3	3896983	3946983
Aspergillus_fumigatus_1F1SW_F4	19	18	1	0	scaffold_2	909864	959864
Aspergillus_fumigatus_1F1SW_F4	20	18	2	0	scaffold_4	1533766	1583766
Aspergillus_fumigatus_1F1SW_F4	18	16	2	0	scaffold_2	2878431	2928431
Aspergillus_fumigatus_1F1SW_F4	0	0	0	0	scaffold_4	1116808	1166808
Aspergillus_fumigatus_1F1SW_F4	23	18	5	0	scaffold_2	1830227	1880227
Aspergillus_fumigatus_1F1SW_F4	20	19	1	0	scaffold_7	1652275	1702275
Aspergillus_fumigatus_1F1SW_F4	9	7	2	0	scaffold_6	2843973	2893973
Aspergillus_fumigatus_1F1SW_F4	17	15	2	0	scaffold_2	675805	725805
Aspergillus_fumigatus_1F1SW_F4	19	17	2	0	scaffold_6	3430436	3480436
Aspergillus_fumigatus_1F1SW_F4	24	23	1	0	scaffold_4	2718395	2768395
Aspergillus_fumigatus_1F1SW_F4	20	18	2	0	scaffold_4	210239	260239
Aspergillus_fumigatus_1F1SW_F4	17	16	1	0	scaffold_8	553839	603839
Aspergillus_fumigatus_1F1SW_F4	18	17	1	0	scaffold_1	2141060	2191060
Aspergillus_fumigatus_1F1SW_F4	16	15	1	0	scaffold_2	3898404	3948404
Aspergillus_fumigatus_1F1SW_F4	23	19	4	0	scaffold_2	3537239	3587239
Aspergillus_fumigatus_1F1SW_F4	21	20	1	0	scaffold_8	997479	1047479
Aspergillus_fumigatus_1F1SW_F4	16	14	2	0	scaffold_2	4106807	4156807
Aspergillus_fumigatus_1F1SW_F4	20	16	4	0	scaffold_5	3294882	3344882
Aspergillus_fumigatus_1F1SW_F4	20	17	3	0	scaffold_1	1189961	1239961
Aspergillus_fumigatus_1F1SW_F4	18	17	1	0	scaffold_7	717605	767605
Aspergillus_fumigatus_1F1SW_F4	16	15	1	0	scaffold_1	2172210	2222210
Aspergillus_fumigatus_1F1SW_F4	16	14	2	0	scaffold_5	3126206	3176206
Aspergillus_fumigatus_1F1SW_F4	8	8	0	0	scaffold_1	1687046	1737046
Aspergillus_fumigatus_1F1SW_F4	20	18	2	0	scaffold_5	2931914	2981914
Aspergillus_fumigatus_1F1SW_F4	20	18	2	0	scaffold_6	594312	644312
Aspergillus_fumigatus_1F1SW_F4	15	14	1	0	scaffold_6	2326932	2376932
Aspergillus_fumigatus_1F1SW_F4	18	13	5	0	scaffold_5	957219	1007219
Aspergillus_fumigatus_1F1SW_F4	23	19	4	0	scaffold_4	501182	551182
Aspergillus_fumigatus_1F1SW_F4	18	17	1	0	scaffold_2	3924954	3974954
Aspergillus_fumigatus_1F1SW_F4	13	12	1	0	scaffold_5	2721809	2771809
Aspergillus_fumigatus_1F1SW_F4	17	16	1	0	scaffold_3	2929351	2979351
Aspergillus_fumigatus_1F1SW_F4	23	22	1	0	scaffold_7	1391804	1441804
Aspergillus_fumigatus_1F1SW_F4	26	24	2	0	scaffold_3	1873263	1923263
Aspergillus_fumigatus_1F1SW_F4	23	18	5	0	scaffold_7	1699671	1749671
Aspergillus_fumigatus_1F1SW_F4	20	18	2	0	scaffold_5	3037875	3087875
Aspergillus_fumigatus_1F1SW_F4	18	16	2	0	scaffold_4	887177	937177
Aspergillus_fumigatus_1F1SW_F4	19	16	3	0	scaffold_7	1521475	1571475
Aspergillus_fumigatus_1F1SW_F4	25	12	13	0	scaffold_4	2430543	2480543
Aspergillus_fumigatus_1F1SW_F4	8	8	0	0	scaffold_1	1683229	1733229
Aspergillus_fumigatus_1F1SW_F4	21	19	2	0	scaffold_1	132700	182700
Aspergillus_fumigatus_1F1SW_F4	19	17	2	0	scaffold_1	353773	403773
Aspergillus_fumigatus_1F1SW_F4	16	15	1	0	scaffold_6	452129	502129
Aspergillus_fumigatus_1F1SW_F4	21	19	2	0	scaffold_5	1877325	1927325
Aspergillus_fumigatus_1F1SW_F4	21	16	5	0	scaffold_5	1929898	1979898
Aspergillus_fumigatus_1F1SW_F4	14	14	0	0	scaffold_4	2332436	2382436
Aspergillus_fumigatus_1F1SW_F4	16	14	2	0	scaffold_2	676800	726800
Aspergillus_fumigatus_1F1SW_F4	20	18	2	0	scaffold_3	2444401	2494401
Aspergillus_fumigatus_1F1SW_F4	19	16	3	0	scaffold_1	3528309	3578309
Aspergillus_fumigatus_1F1SW_F4	18	17	1	0	scaffold_6	1565133	1615133
Aspergillus_fumigatus_1F1SW_F4	16	16	0	0	scaffold_6	3009612	3059612
Aspergillus_fumigatus_1F1SW_F4	22	21	1	0	scaffold_4	1595133	1645133
Aspergillus_fumigatus_1F1SW_F4	17	16	1	0	scaffold_5	2685926	2735926
Aspergillus_fumigatus_1F1SW_F4	22	19	3	0	scaffold_2	4473690	4523690
Aspergillus_fumigatus_1F1SW_F4	21	18	3	0	scaffold_2	150339	200339
Aspergillus_fumigatus_1F1SW_F4	20	19	1	0	scaffold_2	649652	699652
Aspergillus_fumigatus_1F1SW_F4	15	13	2	0	scaffold_6	1790504	1840504
Aspergillus_fumigatus_1F1SW_F4	18	18	0	0	scaffold_6	92089	142089
Aspergillus_fumigatus_1F1SW_F4	13	13	0	0	scaffold_1	761401	811401
Aspergillus_fumigatus_1F1SW_F4	14	13	1	0	scaffold_7	471874	521874
Aspergillus_fumigatus_1F1SW_F4	21	20	1	0	scaffold_5	900315	950315
Aspergillus_fumigatus_1F1SW_F4	19	18	1	0	scaffold_4	329728	379728
Aspergillus_fumigatus_1F1SW_F4	20	15	5	0	scaffold_6	2907460	2957460
Aspergillus_fumigatus_1F1SW_F4	18	15	3	0	scaffold_6	1372152	1422152
Aspergillus_fumigatus_1F1SW_F4	18	17	1	0	scaffold_2	638311	688311
Aspergillus_fumigatus_1F1SW_F4	13	12	1	0	scaffold_4	1854858	1904858
Aspergillus_fumigatus_1F1SW_F4	18	18	0	0	scaffold_5	1842631	1892631
Aspergillus_fumigatus_1F1SW_F4	17	17	0	0	scaffold_4	3246713	3296713
Aspergillus_fumigatus_1F1SW_F4	21	19	2	0	scaffold_3	1366054	1416054
Aspergillus_fumigatus_1F1SW_F4	15	0	15	0	scaffold_1	4168015	4218015
Aspergillus_fumigatus_1F1SW_F4	20	15	5	0	scaffold_2	4502793	4552793
Aspergillus_fumigatus_1F1SW_F4	20	19	1	0	scaffold_2	2860917	2910917
Aspergillus_fumigatus_1F1SW_F4	19	18	1	0	scaffold_2	262264	312264
Aspergillus_fumigatus_1F1SW_F4	20	18	2	0	scaffold_1	2465051	2515051
Aspergillus_fumigatus_1F1SW_F4	19	19	0	0	scaffold_6	1869331	1919331
Aspergillus_fumigatus_1F1SW_F4	24	19	5	0	scaffold_8	1303093	1353093
Aspergillus_fumigatus_1F1SW_F4	19	18	1	0	scaffold_1	215622	265622
Aspergillus_fumigatus_1F1SW_F4	21	19	2	0	scaffold_1	1156924	1206924
Aspergillus_fumigatus_1F1SW_F4	20	15	5	0	scaffold_1	4042662	4092662
Aspergillus_fumigatus_1F1SW_F4	22	20	2	0	scaffold_2	1549156	1599156
Aspergillus_fumigatus_1F1SW_F4	18	16	2	0	scaffold_6	1012489	1062489
Aspergillus_fumigatus_1F1SW_F4	23	18	5	0	scaffold_5	512868	562868
Aspergillus_fumigatus_1F1SW_F4	19	15	4	0	scaffold_4	622396	672396
Aspergillus_fumigatus_1F1SW_F4	21	15	6	0	scaffold_2	2721384	2771384
Aspergillus_fumigatus_1F1SW_F4	17	17	0	0	scaffold_1	2715557	2765557
Aspergillus_fumigatus_1F1SW_F4	19	18	1	0	scaffold_6	3403798	3453798
Aspergillus_fumigatus_1F1SW_F4	21	19	2	0	scaffold_3	1355541	1405541
Aspergillus_fumigatus_1F1SW_F4	22	22	0	0	scaffold_2	414201	464201
Aspergillus_fumigatus_1F1SW_F4	23	18	5	0	scaffold_1	3766764	3816764
Aspergillus_fumigatus_1F1SW_F4	17	17	0	0	scaffold_3	4056458	4106458
Aspergillus_fumigatus_1F1SW_F4	19	14	5	0	scaffold_6	3449030	3499030
Aspergillus_fumigatus_1F1SW_F4	16	6	10	0	scaffold_5	604451	654451
Aspergillus_fumigatus_1F1SW_F4	22	20	2	0	scaffold_3	3040050	3090050
Aspergillus_fumigatus_1F1SW_F4	13	12	1	0	scaffold_1	2205819	2255819
Aspergillus_fumigatus_1F1SW_F4	22	19	3	0	scaffold_5	1884469	1934469
Aspergillus_fumigatus_1F1SW_F4	24	23	1	0	scaffold_4	2544496	2594496
Aspergillus_fumigatus_1F1SW_F4	21	16	5	0	scaffold_2	1833736	1883736
Aspergillus_fumigatus_1F1SW_F4	21	17	4	0	scaffold_2	4341312	4391312
Aspergillus_fumigatus_1F1SW_F4	23	19	4	0	scaffold_3	2865939	2915939
Aspergillus_fumigatus_1F1SW_F4	13	11	2	0	scaffold_4	438275	488275
Aspergillus_fumigatus_1F1SW_F4	21	16	5	0	scaffold_2	2732716	2782716
Aspergillus_fumigatus_1F1SW_F4	23	20	3	0	scaffold_6	2164982	2214982
Aspergillus_fumigatus_1F1SW_F4	25	19	6	0	scaffold_7	121314	171314
Aspergillus_fumigatus_1F1SW_F4	15	14	1	0	scaffold_3	559284	609284
Aspergillus_fumigatus_1F1SW_F4	24	20	4	0	scaffold_6	2179342	2229342
Aspergillus_fumigatus_1F1SW_F4	17	16	1	0	scaffold_4	2798823	2848823
Aspergillus_fumigatus_1F1SW_F4	16	13	3	0	scaffold_3	1821826	1871826
Aspergillus_fumigatus_1F1SW_F4	14	14	0	0	scaffold_1	2080122	2130122
Aspergillus_fumigatus_1F1SW_F4	16	16	0	0	scaffold_2	2553774	2603774
Aspergillus_fumigatus_1F1SW_F4	14	6	8	0	scaffold_5	2546044	2596044
Aspergillus_fumigatus_1F1SW_F4	17	17	0	0	scaffold_4	931244	981244
Aspergillus_fumigatus_1F1SW_F4	20	16	4	0	scaffold_6	156640	206640
Aspergillus_fumigatus_1F1SW_F4	24	20	4	0	scaffold_5	80062	130062
Aspergillus_fumigatus_1F1SW_F4	17	13	4	0	scaffold_1	3975235	4025235
Aspergillus_fumigatus_1F1SW_F4	18	16	2	0	scaffold_2	1298908	1348908
Aspergillus_fumigatus_1F1SW_F4	21	20	1	0	scaffold_6	2277994	2327994
Aspergillus_fumigatus_1F1SW_F4	14	13	1	0	scaffold_4	2789169	2839169
Aspergillus_fumigatus_1F1SW_F4	19	18	1	0	scaffold_3	1735939	1785939
Aspergillus_fumigatus_1F1SW_F4	17	16	1	0	scaffold_6	545755	595755
Aspergillus_fumigatus_1F1SW_F4	23	19	4	0	scaffold_1	117074	167074
Aspergillus_fumigatus_1F1SW_F4	21	17	4	0	scaffold_1	59136	109136
Aspergillus_fumigatus_1F1SW_F4	18	18	0	0	scaffold_6	1924304	1974304
Aspergillus_fumigatus_1F1SW_F4	20	18	2	0	scaffold_3	1468107	1518107
Aspergillus_fumigatus_1F1SW_F4	25	23	2	0	scaffold_7	1793834	1843834
Aspergillus_fumigatus_1F1SW_F4	18	15	3	0	scaffold_3	3092596	3142596
Aspergillus_fumigatus_1F1SW_F4	23	22	1	0	scaffold_2	2386432	2436432
Aspergillus_fumigatus_1F1SW_F4	15	14	1	0	scaffold_4	3401904	3451904
Aspergillus_fumigatus_1F1SW_F4	24	22	2	0	scaffold_5	447013	497013
Aspergillus_fumigatus_1F1SW_F4	28	20	8	0	scaffold_1	3938237	3988237
Aspergillus_fumigatus_1F1SW_F4	28	22	6	0	scaffold_4	3570258	3620258
Aspergillus_fumigatus_1F1SW_F4	16	14	2	0	scaffold_4	3527025	3577025
Aspergillus_fumigatus_1F1SW_F4	21	18	3	0	scaffold_8	722121	772121
Aspergillus_fumigatus_1F1SW_F4	24	20	4	0	scaffold_5	3375238	3425238
Aspergillus_fumigatus_1F1SW_F4	5	4	1	0	scaffold_3	2675446	2725446
Aspergillus_fumigatus_1F1SW_F4	28	20	8	0	scaffold_1	3946479	3996479
Aspergillus_fumigatus_1F1SW_F4	21	21	0	0	scaffold_2	267390	317390
Aspergillus_fumigatus_1F1SW_F4	19	16	3	0	scaffold_7	1301798	1351798
Aspergillus_fumigatus_1F1SW_F4	20	20	0	0	scaffold_2	4203732	4253732
Aspergillus_fumigatus_1F1SW_F4	16	16	0	0	scaffold_3	1764293	1814293
Aspergillus_fumigatus_1F1SW_F4	19	17	2	0	scaffold_1	1974717	2024717
Aspergillus_fumigatus_1F1SW_F4	14	11	3	0	scaffold_4	2668276	2718276
Aspergillus_fumigatus_1F1SW_F4	21	20	1	0	scaffold_1	713254	763254
Aspergillus_fumigatus_1F1SW_F4	18	18	0	0	scaffold_6	1748975	1798975
Aspergillus_fumigatus_1F1SW_F4	16	15	1	0	scaffold_1	1321710	1371710
Aspergillus_fumigatus_1F1SW_F4	17	16	1	0	scaffold_6	554452	604452
Aspergillus_fumigatus_1F1SW_F4	10	10	0	0	scaffold_5	191580	241580
Aspergillus_fumigatus_1F1SW_F4	12	12	0	0	scaffold_2	1175332	1225332
Aspergillus_fumigatus_1F1SW_F4	23	20	3	0	scaffold_1	3546311	3596311
Aspergillus_fumigatus_1F1SW_F4	21	18	2	1	scaffold_7	1354739	1404739
Aspergillus_fumigatus_1F1SW_F4	8	6	2	0	scaffold_7	614025	664025
Aspergillus_fumigatus_1F1SW_F4	19	19	0	0	scaffold_3	1138185	1188185
Aspergillus_fumigatus_1F1SW_F4	17	14	3	0	scaffold_3	3376879	3426879
Aspergillus_fumigatus_1F1SW_F4	9	9	0	0	scaffold_5	1258621	1308621
Aspergillus_fumigatus_1F1SW_F4	16	16	0	0	scaffold_1	1768099	1818099
Aspergillus_fumigatus_1F1SW_F4	19	18	1	0	scaffold_3	830509	880509
Aspergillus_fumigatus_1F1SW_F4	18	18	0	0	scaffold_1	1744506	1794506
Aspergillus_fumigatus_1F1SW_F4	21	16	5	0	scaffold_2	1822995	1872995
Aspergillus_fumigatus_1F1SW_F4	23	22	1	0	scaffold_4	2117290	2167290
Aspergillus_fumigatus_1F1SW_F4	19	17	2	0	scaffold_5	2488389	2538389
Aspergillus_fumigatus_1F1SW_F4	17	16	1	0	scaffold_1	967000	1017000
Aspergillus_fumigatus_1F1SW_F4	22	21	1	0	scaffold_2	273424	323424
Aspergillus_fumigatus_1F1SW_F4	16	15	1	0	scaffold_2	829512	879512
Aspergillus_fumigatus_1F1SW_F4	20	19	1	0	scaffold_1	1339830	1389830
Aspergillus_fumigatus_1F1SW_F4	23	19	4	0	scaffold_5	65298	115298
Aspergillus_fumigatus_1F1SW_F4	18	18	0	0	scaffold_6	308562	358562
Aspergillus_fumigatus_1F1SW_F4	19	18	1	0	scaffold_6	1565995	1615995
Aspergillus_fumigatus_1F1SW_F4	8	8	0	0	scaffold_5	1050418	1100418
Aspergillus_fumigatus_1F1SW_F4	15	15	0	0	scaffold_7	1187720	1237720
Aspergillus_fumigatus_1F1SW_F4	23	22	1	0	scaffold_7	161137	211137
Aspergillus_fumigatus_1F1SW_F4	14	12	2	0	scaffold_7	265543	315543
Aspergillus_fumigatus_1F1SW_F4	17	15	2	0	scaffold_3	3154182	3204182
Aspergillus_fumigatus_1F1SW_F4	19	16	3	0	scaffold_7	315981	365981
Aspergillus_fumigatus_1F1SW_F4	23	21	2	0	scaffold_3	2976876	3026876
Aspergillus_fumigatus_1F1SW_F4	17	16	1	0	scaffold_6	574856	624856
Aspergillus_fumigatus_1F1SW_F4	15	14	1	0	scaffold_8	482946	532946
Aspergillus_fumigatus_1F1SW_F4	19	17	2	0	scaffold_1	2134439	2184439
Aspergillus_fumigatus_1F1SW_F4	18	18	0	0	scaffold_2	2263027	2313027
Aspergillus_fumigatus_1F1SW_F4	19	18	1	0	scaffold_4	771474	821474
Aspergillus_fumigatus_1F1SW_F4	18	8	10	0	scaffold_5	600339	650339
Aspergillus_fumigatus_1F1SW_F4	19	18	1	0	scaffold_5	717768	767768
Aspergillus_fumigatus_1F1SW_F4	14	13	1	0	scaffold_3	532132	582132
Aspergillus_fumigatus_1F1SW_F4	17	15	2	0	scaffold_1	3334352	3384352
Aspergillus_fumigatus_1F1SW_F4	18	15	3	0	scaffold_3	1030231	1080231
Aspergillus_fumigatus_1F1SW_F4	15	13	2	0	scaffold_7	654616	704616
Aspergillus_fumigatus_1F1SW_F4	23	21	2	0	scaffold_3	2435226	2485226
Aspergillus_fumigatus_1F1SW_F4	17	15	2	0	scaffold_3	1256501	1306501
Aspergillus_fumigatus_1F1SW_F4	19	19	0	0	scaffold_6	770980	820980
Aspergillus_fumigatus_1F1SW_F4	21	21	0	0	scaffold_5	3599928	3649928
Aspergillus_fumigatus_1F1SW_F4	19	18	1	0	scaffold_6	2624784	2674784
Aspergillus_fumigatus_1F1SW_F4	15	15	0	0	scaffold_1	3828991	3878991
Aspergillus_fumigatus_1F1SW_F4	21	19	2	0	scaffold_2	1539958	1589958
Aspergillus_fumigatus_1F1SW_F4	15	14	1	0	scaffold_2	1201113	1251113
Aspergillus_fumigatus_1F1SW_F4	24	21	3	0	scaffold_5	382132	432132
Aspergillus_fumigatus_1F1SW_F4	19	17	2	0	scaffold_5	840016	890016
Aspergillus_fumigatus_1F1SW_F4	16	15	1	0	scaffold_4	611220	661220
Aspergillus_fumigatus_1F1SW_F4	25	23	2	0	scaffold_4	682492	732492
Aspergillus_fumigatus_1F1SW_F4	23	21	2	0	scaffold_4	38573	88573
Aspergillus_fumigatus_1F1SW_F4	15	13	2	0	scaffold_5	2753391	2803391
Aspergillus_fumigatus_1F1SW_F4	19	2	17	0	scaffold_5	649048	699048
Aspergillus_fumigatus_1F1SW_F4	17	17	0	0	scaffold_4	1022639	1072639
Aspergillus_fumigatus_1F1SW_F4	16	14	2	0	scaffold_5	2293441	2343441
Aspergillus_fumigatus_1F1SW_F4	9	8	1	0	scaffold_4	1968766	2018766
Aspergillus_fumigatus_1F1SW_F4	13	12	1	0	scaffold_2	1190287	1240287
Aspergillus_fumigatus_1F1SW_F4	22	18	4	0	scaffold_6	2930417	2980417
Aspergillus_fumigatus_1F1SW_F4	20	19	1	0	scaffold_2	3619427	3669427
Aspergillus_fumigatus_1F1SW_F4	20	17	3	0	scaffold_2	4346800	4396800
Aspergillus_fumigatus_1F1SW_F4	17	16	1	0	scaffold_6	1772691	1822691
Aspergillus_fumigatus_1F1SW_F4	18	17	1	0	scaffold_2	1759155	1809155
Aspergillus_fumigatus_1F1SW_F4	16	16	0	0	scaffold_2	1949133	1999133
Aspergillus_fumigatus_1F1SW_F4	13	12	1	0	scaffold_2	3440695	3490695
Aspergillus_fumigatus_1F1SW_F4	16	7	9	0	scaffold_5	2580307	2630307
Aspergillus_fumigatus_1F1SW_F4	17	13	4	0	scaffold_1	3756538	3806538
Aspergillus_fumigatus_1F1SW_F4	16	16	0	0	scaffold_2	1112764	1162764
Aspergillus_fumigatus_1F1SW_F4	18	11	7	0	scaffold_5	593771	643771
Aspergillus_fumigatus_1F1SW_F4	20	15	5	0	scaffold_1	3425734	3475734
Aspergillus_fumigatus_1F1SW_F4	17	17	0	0	scaffold_5	1784489	1834489
Aspergillus_fumigatus_1F1SW_F4	16	14	2	0	scaffold_4	1865618	1915618
Aspergillus_fumigatus_1F1SW_F4	18	16	2	0	scaffold_7	1022639	1072639
Aspergillus_fumigatus_1F1SW_F4	21	14	7	0	scaffold_2	2703814	2753814
Aspergillus_fumigatus_1F1SW_F4	19	19	0	0	scaffold_1	1737391	1787391
Aspergillus_fumigatus_1F1SW_F4	25	22	3	0	scaffold_7	1784987	1834987
Aspergillus_fumigatus_1F1SW_F4	9	7	2	0	scaffold_4	1952310	2002310
Aspergillus_fumigatus_1F1SW_F4	15	15	0	0	scaffold_3	1755984	1805984
Aspergillus_fumigatus_1F1SW_F4	12	12	0	0	scaffold_2	3951691	4001691
Aspergillus_fumigatus_1F1SW_F4	17	15	2	0	scaffold_3	514326	564326
Aspergillus_fumigatus_1F1SW_F4	6	1	5	0	scaffold_5	1007546	1057546
Aspergillus_fumigatus_1F1SW_F4	18	17	1	0	scaffold_3	1167685	1217685
Aspergillus_fumigatus_1F1SW_F4	17	15	2	0	scaffold_3	513987	563987
Aspergillus_fumigatus_1F1SW_F4	23	20	3	0	scaffold_6	3246024	3296024
Aspergillus_fumigatus_1F1SW_F4	20	19	1	0	scaffold_4	1822578	1872578
Aspergillus_fumigatus_1F1SW_F4	0	0	0	0	scaffold_4	1087506	1137506
Aspergillus_fumigatus_1F1SW_F4	23	0	23	0	scaffold_1	4264311	4314311
Aspergillus_fumigatus_1F1SW_F4	21	18	3	0	scaffold_8	274178	324178
Aspergillus_fumigatus_1F1SW_F4	24	23	1	0	scaffold_7	35357	85357
Aspergillus_fumigatus_1F1SW_F4	19	17	2	0	scaffold_3	3164757	3214757
Aspergillus_fumigatus_1F1SW_F4	19	15	4	0	scaffold_3	2800994	2850994
Aspergillus_fumigatus_1F1SW_F4	17	17	0	0	scaffold_1	502300	552300
Aspergillus_fumigatus_1F1SW_F4	20	17	3	0	scaffold_1	2549114	2599114
Aspergillus_fumigatus_1F1SW_F4	20	19	1	0	scaffold_1	1840051	1890051
Aspergillus_fumigatus_1F1SW_F4	12	8	4	0	scaffold_3	4103345	4153345
Aspergillus_fumigatus_1F1SW_F4	22	22	0	0	scaffold_5	567615	617615
Aspergillus_fumigatus_1F1SW_F4	19	18	1	0	scaffold_3	2094784	2144784
Aspergillus_fumigatus_1F1SW_F4	21	19	2	0	scaffold_3	1706952	1756952
Aspergillus_fumigatus_1F1SW_F4	22	19	3	0	scaffold_2	1854423	1904423
Aspergillus_fumigatus_1F1SW_F4	18	16	2	0	scaffold_8	750585	800585
Aspergillus_fumigatus_1F1SW_F4	1	1	0	0	scaffold_5	162769	212769
Aspergillus_fumigatus_1F1SW_F4	17	16	1	0	scaffold_8	574656	624656
Aspergillus_fumigatus_1F1SW_F4	16	13	3	0	scaffold_7	1310496	1360496
Aspergillus_fumigatus_1F1SW_F4	19	19	0	0	scaffold_6	2794915	2844915
Aspergillus_fumigatus_1F1SW_F4	18	18	0	0	scaffold_6	1932138	1982138
Aspergillus_fumigatus_1F1SW_F4	18	17	1	0	scaffold_2	637586	687586
Aspergillus_fumigatus_1F1SW_F4	15	14	1	0	scaffold_5	1421031	1471031
Aspergillus_fumigatus_1F1SW_F4	20	18	2	0	scaffold_1	3183314	3233314
Aspergillus_fumigatus_1F1SW_F4	17	17	0	0	scaffold_4	1502703	1552703
Aspergillus_fumigatus_1F1SW_F4	0	0	0	0	scaffold_4	1128531	1178531
Aspergillus_fumigatus_1F1SW_F4	23	21	2	0	scaffold_1	2003878	2053878
Aspergillus_fumigatus_1F1SW_F4	19	18	1	0	scaffold_4	2705089	2755089
Aspergillus_fumigatus_1F1SW_F4	20	19	1	0	scaffold_2	3674734	3724734
Aspergillus_fumigatus_1F1SW_F4	18	16	2	0	scaffold_2	3731535	3781535
Aspergillus_fumigatus_1F1SW_F4	20	20	0	0	scaffold_6	50574	100574
Aspergillus_fumigatus_1F1SW_F4	6	1	5	0	scaffold_5	1012552	1062552
Aspergillus_fumigatus_1F1SW_F4	20	18	2	0	scaffold_4	1532219	1582219
Aspergillus_fumigatus_1F1SW_F4	19	17	2	0	scaffold_3	1545608	1595608
Aspergillus_fumigatus_1F1SW_F4	19	19	0	0	scaffold_6	363992	413992
Aspergillus_fumigatus_1F1SW_F4	16	14	2	0	scaffold_5	3128284	3178284
Aspergillus_fumigatus_1F1SW_F4	18	16	2	0	scaffold_4	3651069	3701069
Aspergillus_fumigatus_1F1SW_F4	20	17	2	1	scaffold_7	1347753	1397753
Aspergillus_fumigatus_1F1SW_F4	15	12	3	0	scaffold_3	3482770	3532770
