STRAIN	TOTAL	CORE	ACCESSORY	SINGLETON	CHROM	START	END
Aspergillus_fumigatus_B5866	46	43	3	0	scaffold_5	2626894	2726894
Aspergillus_fumigatus_B5866	42	37	5	0	scaffold_6	2168554	2268554
Aspergillus_fumigatus_B5866	43	42	1	0	scaffold_1	4689892	4789892
Aspergillus_fumigatus_B5866	41	36	5	0	scaffold_1	4550971	4650971
Aspergillus_fumigatus_B5866	31	28	3	0	scaffold_3	3251530	3351530
Aspergillus_fumigatus_B5866	33	31	2	0	scaffold_4	765062	865062
Aspergillus_fumigatus_B5866	6	2	4	0	scaffold_2	57543	157543
Aspergillus_fumigatus_B5866	39	36	3	0	scaffold_5	863814	963814
Aspergillus_fumigatus_B5866	40	39	1	0	scaffold_8	930840	1030840
Aspergillus_fumigatus_B5866	37	34	3	0	scaffold_4	2407563	2507563
Aspergillus_fumigatus_B5866	39	33	6	0	scaffold_5	2900427	3000427
Aspergillus_fumigatus_B5866	38	27	11	0	scaffold_1	4475304	4575304
Aspergillus_fumigatus_B5866	37	34	3	0	scaffold_6	9860	109860
Aspergillus_fumigatus_B5866	39	39	0	0	scaffold_5	3146018	3246018
Aspergillus_fumigatus_B5866	38	36	2	0	scaffold_2	430422	530422
Aspergillus_fumigatus_B5866	30	22	8	0	scaffold_5	2516122	2616122
Aspergillus_fumigatus_B5866	39	37	2	0	scaffold_3	3861245	3961245
Aspergillus_fumigatus_B5866	30	29	1	0	scaffold_1	3030610	3130610
Aspergillus_fumigatus_B5866	42	35	7	0	scaffold_6	495443	595443
Aspergillus_fumigatus_B5866	27	24	3	0	scaffold_6	379612	479612
Aspergillus_fumigatus_B5866	37	15	22	0	scaffold_1	4441800	4541800
Aspergillus_fumigatus_B5866	34	30	4	0	scaffold_1	3560176	3660176
Aspergillus_fumigatus_B5866	39	37	2	0	scaffold_5	747542	847542
Aspergillus_fumigatus_B5866	40	39	1	0	scaffold_7	600389	700389
Aspergillus_fumigatus_B5866	30	28	2	0	scaffold_2	2609857	2709857
Aspergillus_fumigatus_B5866	35	25	10	0	scaffold_4	3264577	3364577
Aspergillus_fumigatus_B5866	34	32	2	0	scaffold_4	1411797	1511797
Aspergillus_fumigatus_B5866	37	32	5	0	scaffold_1	3807253	3907253
Aspergillus_fumigatus_B5866	33	29	4	0	scaffold_3	3220854	3320854
Aspergillus_fumigatus_B5866	23	23	0	0	scaffold_6	1015792	1115792
Aspergillus_fumigatus_B5866	37	35	2	0	scaffold_5	1372140	1472140
Aspergillus_fumigatus_B5866	39	37	2	0	scaffold_3	1023777	1123777
Aspergillus_fumigatus_B5866	43	39	4	0	scaffold_6	1541923	1641923
Aspergillus_fumigatus_B5866	31	29	2	0	scaffold_2	3416604	3516604
Aspergillus_fumigatus_B5866	34	30	4	0	scaffold_1	1094979	1194979
Aspergillus_fumigatus_B5866	32	30	2	0	scaffold_3	2855865	2955865
Aspergillus_fumigatus_B5866	34	33	1	0	scaffold_6	2953715	3053715
Aspergillus_fumigatus_B5866	36	33	3	0	scaffold_3	2521596	2621596
Aspergillus_fumigatus_B5866	36	34	2	0	scaffold_5	1367607	1467607
Aspergillus_fumigatus_B5866	43	40	3	0	scaffold_2	2315716	2415716
Aspergillus_fumigatus_B5866	37	27	10	0	scaffold_1	4483985	4583985
Aspergillus_fumigatus_B5866	19	19	0	0	scaffold_8	643157	743157
Aspergillus_fumigatus_B5866	30	30	0	0	scaffold_3	1659550	1759550
Aspergillus_fumigatus_B5866	32	32	0	0	scaffold_2	876527	976527
Aspergillus_fumigatus_B5866	30	26	4	0	scaffold_1	1940413	2040413
Aspergillus_fumigatus_B5866	40	37	3	0	scaffold_2	2284675	2384675
Aspergillus_fumigatus_B5866	40	39	1	0	scaffold_4	259550	359550
Aspergillus_fumigatus_B5866	35	8	27	0	scaffold_1	4218329	4318329
Aspergillus_fumigatus_B5866	38	35	3	0	scaffold_4	2320320	2420320
Aspergillus_fumigatus_B5866	45	38	7	0	scaffold_8	194223	294223
Aspergillus_fumigatus_B5866	37	34	3	0	scaffold_5	451481	551481
Aspergillus_fumigatus_B5866	32	29	3	0	scaffold_1	1002808	1102808
Aspergillus_fumigatus_B5866	44	40	4	0	scaffold_1	4614491	4714491
Aspergillus_fumigatus_B5866	36	35	1	0	scaffold_2	3579583	3679583
Aspergillus_fumigatus_B5866	34	30	4	0	scaffold_3	3198425	3298425
Aspergillus_fumigatus_B5866	41	36	5	0	scaffold_5	681030	781030
Aspergillus_fumigatus_B5866	31	30	1	0	scaffold_4	732013	832013
Aspergillus_fumigatus_B5866	39	32	7	0	scaffold_1	3133018	3233018
Aspergillus_fumigatus_B5866	39	38	1	0	scaffold_7	607925	707925
Aspergillus_fumigatus_B5866	38	35	3	0	scaffold_4	1752235	1852235
Aspergillus_fumigatus_B5866	47	40	7	0	scaffold_8	1521843	1621843
Aspergillus_fumigatus_B5866	38	23	15	0	scaffold_5	2228178	2328178
Aspergillus_fumigatus_B5866	40	38	2	0	scaffold_2	2773591	2873591
Aspergillus_fumigatus_B5866	34	19	15	0	scaffold_5	2211542	2311542
Aspergillus_fumigatus_B5866	39	36	3	0	scaffold_2	3003843	3103843
Aspergillus_fumigatus_B5866	45	42	3	0	scaffold_1	4626496	4726496
Aspergillus_fumigatus_B5866	11	9	2	0	scaffold_2	90836	190836
Aspergillus_fumigatus_B5866	35	32	3	0	scaffold_8	1336221	1436221
Aspergillus_fumigatus_B5866	29	28	1	0	scaffold_1	3029553	3129553
Aspergillus_fumigatus_B5866	29	20	9	0	scaffold_3	1944225	2044225
Aspergillus_fumigatus_B5866	38	36	2	0	scaffold_6	2985598	3085598
Aspergillus_fumigatus_B5866	36	31	5	0	scaffold_2	1382345	1482345
Aspergillus_fumigatus_B5866	14	13	1	0	scaffold_6	1110757	1210757
Aspergillus_fumigatus_B5866	38	32	6	0	scaffold_1	1361252	1461252
Aspergillus_fumigatus_B5866	39	38	1	0	scaffold_1	4672540	4772540
Aspergillus_fumigatus_B5866	43	39	4	0	scaffold_5	2589507	2689507
Aspergillus_fumigatus_B5866	43	40	3	0	scaffold_6	2219378	2319378
Aspergillus_fumigatus_B5866	42	37	5	0	scaffold_4	371189	471189
Aspergillus_fumigatus_B5866	40	38	2	0	scaffold_1	2420708	2520708
Aspergillus_fumigatus_B5866	33	27	6	0	scaffold_5	2451107	2551107
Aspergillus_fumigatus_B5866	41	39	2	0	scaffold_6	1813814	1913814
Aspergillus_fumigatus_B5866	36	34	2	0	scaffold_2	439990	539990
Aspergillus_fumigatus_B5866	40	40	0	0	scaffold_5	3195204	3295204
Aspergillus_fumigatus_B5866	19	15	4	0	scaffold_7	730503	830503
Aspergillus_fumigatus_B5866	40	36	4	0	scaffold_7	426699	526699
Aspergillus_fumigatus_B5866	31	29	2	0	scaffold_8	1314376	1414376
Aspergillus_fumigatus_B5866	38	38	0	0	scaffold_2	1605697	1705697
Aspergillus_fumigatus_B5866	38	35	3	0	scaffold_2	1481428	1581428
Aspergillus_fumigatus_B5866	36	34	2	0	scaffold_2	3147807	3247807
Aspergillus_fumigatus_B5866	49	46	3	0	scaffold_3	3804762	3904762
Aspergillus_fumigatus_B5866	42	40	2	0	scaffold_1	485417	585417
Aspergillus_fumigatus_B5866	29	26	3	0	scaffold_2	720898	820898
Aspergillus_fumigatus_B5866	33	29	4	0	scaffold_6	108146	208146
Aspergillus_fumigatus_B5866	41	38	3	0	scaffold_1	2552456	2652456
Aspergillus_fumigatus_B5866	38	38	0	0	scaffold_2	3474808	3574808
Aspergillus_fumigatus_B5866	39	36	3	0	scaffold_6	761018	861018
Aspergillus_fumigatus_B5866	38	37	1	0	scaffold_6	1280217	1380217
Aspergillus_fumigatus_B5866	21	16	5	0	scaffold_5	180583	280583
Aspergillus_fumigatus_B5866	38	35	3	0	scaffold_1	291325	391325
Aspergillus_fumigatus_B5866	31	31	0	0	scaffold_4	1918214	2018214
Aspergillus_fumigatus_B5866	45	40	5	0	scaffold_3	2216186	2316186
Aspergillus_fumigatus_B5866	47	43	4	0	scaffold_3	3823858	3923858
Aspergillus_fumigatus_B5866	34	31	3	0	scaffold_7	1289192	1389192
Aspergillus_fumigatus_B5866	21	14	7	0	scaffold_6	3449888	3549888
Aspergillus_fumigatus_B5866	49	41	8	0	scaffold_8	252992	352992
Aspergillus_fumigatus_B5866	38	38	0	0	scaffold_6	1255884	1355884
Aspergillus_fumigatus_B5866	48	40	8	0	scaffold_4	2510072	2610072
Aspergillus_fumigatus_B5866	40	34	6	0	scaffold_7	300093	400093
Aspergillus_fumigatus_B5866	42	38	4	0	scaffold_2	2990238	3090238
Aspergillus_fumigatus_B5866	38	35	3	0	scaffold_5	1606539	1706539
Aspergillus_fumigatus_B5866	39	36	3	0	scaffold_6	1613418	1713418
Aspergillus_fumigatus_B5866	38	34	4	0	scaffold_1	3340343	3440343
Aspergillus_fumigatus_B5866	37	37	0	0	scaffold_6	2855993	2955993
Aspergillus_fumigatus_B5866	37	34	3	0	scaffold_6	2453305	2553305
Aspergillus_fumigatus_B5866	39	35	4	0	scaffold_7	270873	370873
Aspergillus_fumigatus_B5866	39	36	3	0	scaffold_1	283791	383791
Aspergillus_fumigatus_B5866	39	36	3	0	scaffold_5	1607468	1707468
Aspergillus_fumigatus_B5866	38	36	2	0	scaffold_1	397146	497146
Aspergillus_fumigatus_B5866	36	34	1	1	scaffold_3	3346610	3446610
Aspergillus_fumigatus_B5866	37	32	5	0	scaffold_8	49577	149577
Aspergillus_fumigatus_B5866	36	32	4	0	scaffold_6	3150869	3250869
Aspergillus_fumigatus_B5866	37	36	1	0	scaffold_6	1272081	1372081
Aspergillus_fumigatus_B5866	33	29	4	0	scaffold_3	3200007	3300007
Aspergillus_fumigatus_B5866	43	40	3	0	scaffold_8	1401309	1501309
Aspergillus_fumigatus_B5866	34	31	3	0	scaffold_2	3668677	3768677
Aspergillus_fumigatus_B5866	42	39	3	0	scaffold_5	2027134	2127134
Aspergillus_fumigatus_B5866	31	23	8	0	scaffold_2	2660053	2760053
Aspergillus_fumigatus_B5866	31	28	3	0	scaffold_8	1276016	1376016
Aspergillus_fumigatus_B5866	41	38	3	0	scaffold_1	2552448	2652448
Aspergillus_fumigatus_B5866	33	32	1	0	scaffold_4	677566	777566
Aspergillus_fumigatus_B5866	39	34	5	0	scaffold_1	3238689	3338689
Aspergillus_fumigatus_B5866	37	34	3	0	scaffold_6	1232144	1332144
Aspergillus_fumigatus_B5866	37	36	1	0	scaffold_4	2865720	2965720
Aspergillus_fumigatus_B5866	38	35	3	0	scaffold_2	2256846	2356846
Aspergillus_fumigatus_B5866	27	27	0	0	scaffold_2	2461392	2561392
Aspergillus_fumigatus_B5866	31	27	4	0	scaffold_7	808513	908513
Aspergillus_fumigatus_B5866	34	34	0	0	scaffold_4	3022560	3122560
Aspergillus_fumigatus_B5866	39	38	1	0	scaffold_2	4236187	4336187
Aspergillus_fumigatus_B5866	38	35	3	0	scaffold_2	1765790	1865790
Aspergillus_fumigatus_B5866	34	30	4	0	scaffold_3	3196573	3296573
Aspergillus_fumigatus_B5866	34	34	0	0	scaffold_4	2744277	2844277
Aspergillus_fumigatus_B5866	34	31	3	0	scaffold_3	1277216	1377216
Aspergillus_fumigatus_B5866	43	35	8	0	scaffold_1	187854	287854
Aspergillus_fumigatus_B5866	40	39	1	0	scaffold_7	1029119	1129119
Aspergillus_fumigatus_B5866	34	32	2	0	scaffold_6	48618	148618
Aspergillus_fumigatus_B5866	19	18	1	0	scaffold_5	1200400	1300400
Aspergillus_fumigatus_B5866	34	33	1	0	scaffold_5	2789490	2889490
Aspergillus_fumigatus_B5866	32	25	7	0	scaffold_4	3245685	3345685
Aspergillus_fumigatus_B5866	37	35	2	0	scaffold_3	1703318	1803318
Aspergillus_fumigatus_B5866	33	31	2	0	scaffold_1	886241	986241
Aspergillus_fumigatus_B5866	40	38	2	0	scaffold_6	2230400	2330400
Aspergillus_fumigatus_B5866	41	36	5	0	scaffold_4	2548537	2648537
Aspergillus_fumigatus_B5866	37	26	11	0	scaffold_1	4472922	4572922
Aspergillus_fumigatus_B5866	44	39	5	0	scaffold_7	1620978	1720978
Aspergillus_fumigatus_B5866	35	35	0	0	scaffold_6	2900216	3000216
Aspergillus_fumigatus_B5866	34	32	2	0	scaffold_1	1926443	2026443
Aspergillus_fumigatus_B5866	40	39	1	0	scaffold_7	1042778	1142778
Aspergillus_fumigatus_B5866	38	34	4	0	scaffold_6	3167459	3267459
Aspergillus_fumigatus_B5866	37	36	1	0	scaffold_2	587305	687305
Aspergillus_fumigatus_B5866	39	34	5	0	scaffold_2	4523385	4623385
Aspergillus_fumigatus_B5866	27	18	9	0	scaffold_5	2135396	2235396
Aspergillus_fumigatus_B5866	40	39	1	0	scaffold_2	1674853	1774853
Aspergillus_fumigatus_B5866	38	34	4	0	scaffold_6	3167687	3267687
Aspergillus_fumigatus_B5866	31	26	5	0	scaffold_6	2338748	2438748
Aspergillus_fumigatus_B5866	42	39	3	0	scaffold_6	2236626	2336626
Aspergillus_fumigatus_B5866	32	29	3	0	scaffold_5	1471617	1571617
Aspergillus_fumigatus_B5866	44	38	6	0	scaffold_4	3523147	3623147
Aspergillus_fumigatus_B5866	34	0	34	0	scaffold_1	4271871	4371871
Aspergillus_fumigatus_B5866	41	39	2	0	scaffold_3	1440427	1540427
Aspergillus_fumigatus_B5866	41	36	5	0	scaffold_1	257648	357648
Aspergillus_fumigatus_B5866	41	32	9	0	scaffold_1	4089889	4189889
Aspergillus_fumigatus_B5866	12	12	0	0	scaffold_1	1807449	1907449
Aspergillus_fumigatus_B5866	31	31	0	0	scaffold_4	1913118	2013118
Aspergillus_fumigatus_B5866	42	6	36	0	scaffold_1	4401212	4501212
Aspergillus_fumigatus_B5866	39	37	2	0	scaffold_1	2096450	2196450
Aspergillus_fumigatus_B5866	31	29	2	0	scaffold_5	1725869	1825869
Aspergillus_fumigatus_B5866	41	37	4	0	scaffold_7	23157	123157
Aspergillus_fumigatus_B5866	33	31	2	0	scaffold_4	704073	804073
Aspergillus_fumigatus_B5866	38	35	3	0	scaffold_1	2901721	3001721
Aspergillus_fumigatus_B5866	30	28	2	0	scaffold_5	2734755	2834755
Aspergillus_fumigatus_B5866	38	33	5	0	scaffold_4	357967	457967
Aspergillus_fumigatus_B5866	37	32	5	0	scaffold_4	3357121	3457121
Aspergillus_fumigatus_B5866	41	39	2	0	scaffold_8	843984	943984
Aspergillus_fumigatus_B5866	27	25	2	0	scaffold_2	4570782	4670782
Aspergillus_fumigatus_B5866	38	35	3	0	scaffold_6	1920752	2020752
Aspergillus_fumigatus_B5866	36	22	14	0	scaffold_5	2218681	2318681
Aspergillus_fumigatus_B5866	34	31	3	0	scaffold_4	1833123	1933123
Aspergillus_fumigatus_B5866	35	32	3	0	scaffold_2	3042205	3142205
Aspergillus_fumigatus_B5866	31	28	3	0	scaffold_6	115624	215624
Aspergillus_fumigatus_B5866	43	42	1	0	scaffold_2	4224034	4324034
Aspergillus_fumigatus_B5866	43	42	1	0	scaffold_6	1772167	1872167
Aspergillus_fumigatus_B5866	39	38	1	0	scaffold_3	191127	291127
Aspergillus_fumigatus_B5866	40	38	2	0	scaffold_1	3710762	3810762
Aspergillus_fumigatus_B5866	35	30	5	0	scaffold_6	546048	646048
Aspergillus_fumigatus_B5866	32	28	4	0	scaffold_6	1161147	1261147
Aspergillus_fumigatus_B5866	42	1	41	0	scaffold_1	4370611	4470611
Aspergillus_fumigatus_B5866	45	43	2	0	scaffold_3	170574	270574
Aspergillus_fumigatus_B5866	37	34	3	0	scaffold_5	3070625	3170625
Aspergillus_fumigatus_B5866	36	27	9	0	scaffold_3	2368398	2468398
Aspergillus_fumigatus_B5866	30	27	3	0	scaffold_5	1168242	1268242
Aspergillus_fumigatus_B5866	32	31	1	0	scaffold_2	2482174	2582174
Aspergillus_fumigatus_B5866	32	30	2	0	scaffold_4	1441800	1541800
Aspergillus_fumigatus_B5866	33	31	2	0	scaffold_1	880736	980736
Aspergillus_fumigatus_B5866	32	30	2	0	scaffold_1	1545198	1645198
Aspergillus_fumigatus_B5866	36	33	3	0	scaffold_6	829429	929429
Aspergillus_fumigatus_B5866	40	36	4	0	scaffold_7	433524	533524
Aspergillus_fumigatus_B5866	41	37	4	0	scaffold_2	2212593	2312593
Aspergillus_fumigatus_B5866	43	34	9	0	scaffold_3	982086	1082086
Aspergillus_fumigatus_B5866	38	32	6	0	scaffold_3	3663353	3763353
Aspergillus_fumigatus_B5866	37	33	4	0	scaffold_7	367946	467946
Aspergillus_fumigatus_B5866	40	38	2	0	scaffold_6	1579742	1679742
Aspergillus_fumigatus_B5866	37	27	10	0	scaffold_3	548153	648153
Aspergillus_fumigatus_B5866	34	32	2	0	scaffold_3	2694264	2794264
Aspergillus_fumigatus_B5866	29	27	2	0	scaffold_4	1349660	1449660
Aspergillus_fumigatus_B5866	42	36	6	0	scaffold_3	2268641	2368641
Aspergillus_fumigatus_B5866	42	42	0	0	scaffold_6	2816522	2916522
Aspergillus_fumigatus_B5866	35	33	2	0	scaffold_1	2212430	2312430
Aspergillus_fumigatus_B5866	40	38	2	0	scaffold_1	4667145	4767145
Aspergillus_fumigatus_B5866	34	32	2	0	scaffold_3	3102954	3202954
Aspergillus_fumigatus_B5866	32	29	3	0	scaffold_5	3288415	3388415
Aspergillus_fumigatus_B5866	41	37	4	0	scaffold_8	1464891	1564891
Aspergillus_fumigatus_B5866	46	43	3	0	scaffold_3	3814832	3914832
Aspergillus_fumigatus_B5866	41	37	4	0	scaffold_4	2335347	2435347
Aspergillus_fumigatus_B5866	43	40	3	0	scaffold_5	2067546	2167546
Aspergillus_fumigatus_B5866	44	38	6	0	scaffold_4	3700859	3800859
Aspergillus_fumigatus_B5866	35	28	7	0	scaffold_5	2919397	3019397
Aspergillus_fumigatus_B5866	33	27	6	0	scaffold_3	2413534	2513534
Aspergillus_fumigatus_B5866	35	31	4	0	scaffold_6	3355524	3455524
Aspergillus_fumigatus_B5866	41	39	2	0	scaffold_3	2116297	2216297
Aspergillus_fumigatus_B5866	32	29	3	0	scaffold_5	1839022	1939022
Aspergillus_fumigatus_B5866	39	37	2	0	scaffold_5	876956	976956
Aspergillus_fumigatus_B5866	43	39	4	0	scaffold_8	1470843	1570843
Aspergillus_fumigatus_B5866	40	36	4	0	scaffold_4	2341814	2441814
Aspergillus_fumigatus_B5866	33	32	1	0	scaffold_1	911515	1011515
Aspergillus_fumigatus_B5866	36	34	2	0	scaffold_4	1249631	1349631
Aspergillus_fumigatus_B5866	48	41	7	0	scaffold_7	1366406	1466406
Aspergillus_fumigatus_B5866	32	30	2	0	scaffold_4	2916335	3016335
Aspergillus_fumigatus_B5866	37	35	2	0	scaffold_2	3147989	3247989
Aspergillus_fumigatus_B5866	39	36	3	0	scaffold_5	3387898	3487898
Aspergillus_fumigatus_B5866	40	34	6	0	scaffold_4	1607975	1707975
Aspergillus_fumigatus_B5866	35	33	2	0	scaffold_1	3668928	3768928
Aspergillus_fumigatus_B5866	39	39	0	0	scaffold_4	986560	1086560
Aspergillus_fumigatus_B5866	39	36	3	0	scaffold_3	2995727	3095727
Aspergillus_fumigatus_B5866	40	36	4	0	scaffold_4	2434204	2534204
Aspergillus_fumigatus_B5866	26	23	3	0	scaffold_1	2034203	2134203
Aspergillus_fumigatus_B5866	43	38	5	0	scaffold_8	1121919	1221919
Aspergillus_fumigatus_B5866	36	34	2	0	scaffold_2	2844965	2944965
Aspergillus_fumigatus_B5866	8	8	0	0	scaffold_3	3926178	4026178
Aspergillus_fumigatus_B5866	45	38	7	0	scaffold_7	1435722	1535722
Aspergillus_fumigatus_B5866	36	32	4	0	scaffold_3	2569634	2669634
Aspergillus_fumigatus_B5866	17	15	2	0	scaffold_5	1219869	1319869
Aspergillus_fumigatus_B5866	37	31	6	0	scaffold_1	1383330	1483330
Aspergillus_fumigatus_B5866	29	25	4	0	scaffold_1	1063723	1163723
Aspergillus_fumigatus_B5866	34	30	4	0	scaffold_6	2353605	2453605
Aspergillus_fumigatus_B5866	9	7	2	0	scaffold_4	1113286	1213286
Aspergillus_fumigatus_B5866	32	30	2	0	scaffold_1	1439840	1539840
Aspergillus_fumigatus_B5866	36	33	3	0	scaffold_2	3245010	3345010
Aspergillus_fumigatus_B5866	40	35	5	0	scaffold_4	7280	107280
Aspergillus_fumigatus_B5866	44	41	3	0	scaffold_5	2621812	2721812
Aspergillus_fumigatus_B5866	47	40	7	0	scaffold_8	240759	340759
Aspergillus_fumigatus_B5866	27	26	1	0	scaffold_3	1197062	1297062
Aspergillus_fumigatus_B5866	37	35	2	0	scaffold_8	824384	924384
Aspergillus_fumigatus_B5866	37	34	3	0	scaffold_8	469443	569443
Aspergillus_fumigatus_B5866	42	41	1	0	scaffold_8	855437	955437
Aspergillus_fumigatus_B5866	32	30	2	0	scaffold_7	1271431	1371431
Aspergillus_fumigatus_B5866	17	13	4	0	scaffold_3	685270	785270
Aspergillus_fumigatus_B5866	35	32	3	0	scaffold_2	3012251	3112251
Aspergillus_fumigatus_B5866	32	0	32	0	scaffold_1	4310761	4410761
Aspergillus_fumigatus_B5866	21	16	5	0	scaffold_5	182200	282200
Aspergillus_fumigatus_B5866	43	41	2	0	scaffold_3	504848	604848
Aspergillus_fumigatus_B5866	34	28	6	0	scaffold_7	516170	616170
Aspergillus_fumigatus_B5866	33	31	2	0	scaffold_3	2759738	2859738
Aspergillus_fumigatus_B5866	40	33	7	0	scaffold_4	101992	201992
Aspergillus_fumigatus_B5866	32	26	6	0	scaffold_5	2463672	2563672
Aspergillus_fumigatus_B5866	39	35	4	0	scaffold_5	2874096	2974096
Aspergillus_fumigatus_B5866	38	34	4	0	scaffold_7	395765	495765
Aspergillus_fumigatus_B5866	40	35	5	0	scaffold_3	1814898	1914898
Aspergillus_fumigatus_B5866	42	39	3	0	scaffold_3	3730320	3830320
Aspergillus_fumigatus_B5866	31	30	1	0	scaffold_6	2536989	2636989
Aspergillus_fumigatus_B5866	40	39	1	0	scaffold_2	383152	483152
Aspergillus_fumigatus_B5866	43	40	3	0	scaffold_6	1598954	1698954
Aspergillus_fumigatus_B5866	27	19	8	0	scaffold_5	238929	338929
Aspergillus_fumigatus_B5866	38	35	3	0	scaffold_6	794402	894402
Aspergillus_fumigatus_B5866	33	32	1	0	scaffold_2	3934455	4034455
Aspergillus_fumigatus_B5866	36	33	3	0	scaffold_3	3160681	3260681
Aspergillus_fumigatus_B5866	43	40	3	0	scaffold_3	487143	587143
Aspergillus_fumigatus_B5866	39	37	2	0	scaffold_5	1022882	1122882
Aspergillus_fumigatus_B5866	38	38	0	0	scaffold_6	2770558	2870558
Aspergillus_fumigatus_B5866	35	32	3	0	scaffold_1	2884955	2984955
Aspergillus_fumigatus_B5866	31	30	1	0	scaffold_2	2600561	2700561
Aspergillus_fumigatus_B5866	49	42	7	0	scaffold_4	3663065	3763065
Aspergillus_fumigatus_B5866	46	43	3	0	scaffold_2	2173502	2273502
Aspergillus_fumigatus_B5866	33	31	2	0	scaffold_1	1200707	1300707
Aspergillus_fumigatus_B5866	34	32	2	0	scaffold_1	2493621	2593621
Aspergillus_fumigatus_B5866	32	31	1	0	scaffold_7	1239463	1339463
Aspergillus_fumigatus_B5866	38	37	1	0	scaffold_3	2953988	3053988
Aspergillus_fumigatus_B5866	35	35	0	0	scaffold_1	621328	721328
Aspergillus_fumigatus_B5866	39	36	3	0	scaffold_6	1510456	1610456
Aspergillus_fumigatus_B5866	34	26	8	0	scaffold_5	2921600	3021600
Aspergillus_fumigatus_B5866	35	33	2	0	scaffold_1	1884243	1984243
Aspergillus_fumigatus_B5866	39	35	4	0	scaffold_1	4539742	4639742
Aspergillus_fumigatus_B5866	44	40	4	0	scaffold_3	430263	530263
Aspergillus_fumigatus_B5866	31	30	1	0	scaffold_3	1259633	1359633
Aspergillus_fumigatus_B5866	12	12	0	0	scaffold_1	1818266	1918266
Aspergillus_fumigatus_B5866	39	35	4	0	scaffold_6	3162306	3262306
Aspergillus_fumigatus_B5866	32	32	0	0	scaffold_6	2737458	2837458
Aspergillus_fumigatus_B5866	23	17	6	0	scaffold_5	184648	284648
Aspergillus_fumigatus_B5866	36	32	4	0	scaffold_3	2566159	2666159
Aspergillus_fumigatus_B5866	39	37	2	0	scaffold_5	746826	846826
Aspergillus_fumigatus_B5866	41	39	2	0	scaffold_3	2078420	2178420
Aspergillus_fumigatus_B5866	36	36	0	0	scaffold_6	2893926	2993926
Aspergillus_fumigatus_B5866	39	37	2	0	scaffold_5	1002691	1102691
Aspergillus_fumigatus_B5866	9	6	3	0	scaffold_2	84950	184950
Aspergillus_fumigatus_B5866	45	41	4	0	scaffold_2	2307090	2407090
Aspergillus_fumigatus_B5866	51	42	9	0	scaffold_7	1400643	1500643
Aspergillus_fumigatus_B5866	29	19	10	0	scaffold_3	1934648	2034648
Aspergillus_fumigatus_B5866	28	24	4	0	scaffold_5	100482	200482
Aspergillus_fumigatus_B5866	36	33	3	0	scaffold_5	1951188	2051188
Aspergillus_fumigatus_B5866	37	35	2	0	scaffold_6	1642300	1742300
Aspergillus_fumigatus_B5866	37	35	2	0	scaffold_6	60766	160766
Aspergillus_fumigatus_B5866	40	36	4	0	scaffold_3	838802	938802
Aspergillus_fumigatus_B5866	30	26	4	0	scaffold_1	1055678	1155678
Aspergillus_fumigatus_B5866	47	39	8	0	scaffold_5	27155	127155
Aspergillus_fumigatus_B5866	37	36	1	0	scaffold_4	2645417	2745417
Aspergillus_fumigatus_B5866	30	30	0	0	scaffold_1	2838994	2938994
Aspergillus_fumigatus_B5866	44	39	5	0	scaffold_8	307842	407842
Aspergillus_fumigatus_B5866	37	33	4	0	scaffold_6	3127982	3227982
Aspergillus_fumigatus_B5866	29	28	1	0	scaffold_3	1613079	1713079
Aspergillus_fumigatus_B5866	40	34	6	0	scaffold_6	466487	566487
Aspergillus_fumigatus_B5866	34	32	2	0	scaffold_1	1231589	1331589
Aspergillus_fumigatus_B5866	41	40	1	0	scaffold_6	1697398	1797398
Aspergillus_fumigatus_B5866	42	33	9	0	scaffold_5	2294276	2394276
Aspergillus_fumigatus_B5866	30	30	0	0	scaffold_1	3034131	3134131
Aspergillus_fumigatus_B5866	37	33	4	0	scaffold_4	1764572	1864572
Aspergillus_fumigatus_B5866	37	36	1	0	scaffold_4	2006619	2106619
Aspergillus_fumigatus_B5866	35	33	2	0	scaffold_3	3085440	3185440
Aspergillus_fumigatus_B5866	44	41	3	0	scaffold_8	1413468	1513468
Aspergillus_fumigatus_B5866	24	18	6	0	scaffold_5	188485	288485
Aspergillus_fumigatus_B5866	46	40	6	0	scaffold_6	3256079	3356079
Aspergillus_fumigatus_B5866	42	40	2	0	scaffold_5	3563233	3663233
Aspergillus_fumigatus_B5866	41	36	5	0	scaffold_8	1111206	1211206
Aspergillus_fumigatus_B5866	35	34	1	0	scaffold_2	1888991	1988991
Aspergillus_fumigatus_B5866	31	30	1	0	scaffold_2	1119100	1219100
Aspergillus_fumigatus_B5866	42	38	4	0	scaffold_6	1564976	1664976
Aspergillus_fumigatus_B5866	30	27	3	0	scaffold_2	124573	224573
Aspergillus_fumigatus_B5866	36	34	2	0	scaffold_1	1321874	1421874
Aspergillus_fumigatus_B5866	38	38	0	0	scaffold_4	2585014	2685014
Aspergillus_fumigatus_B5866	37	34	3	0	scaffold_3	2474315	2574315
Aspergillus_fumigatus_B5866	31	28	3	0	scaffold_1	3956707	4056707
Aspergillus_fumigatus_B5866	38	11	27	0	scaffold_1	4203989	4303989
Aspergillus_fumigatus_B5866	31	31	0	0	scaffold_2	832200	932200
Aspergillus_fumigatus_B5866	35	29	6	0	scaffold_7	479985	579985
Aspergillus_fumigatus_B5866	32	24	8	0	scaffold_3	1976151	2076151
Aspergillus_fumigatus_B5866	39	34	5	0	scaffold_8	45075	145075
Aspergillus_fumigatus_B5866	35	33	2	0	scaffold_3	3037786	3137786
Aspergillus_fumigatus_B5866	17	16	1	0	scaffold_3	1140546	1240546
Aspergillus_fumigatus_B5866	39	38	1	0	scaffold_7	596166	696166
Aspergillus_fumigatus_B5866	38	33	5	0	scaffold_1	3914828	4014828
Aspergillus_fumigatus_B5866	41	39	2	0	scaffold_3	1440955	1540955
Aspergillus_fumigatus_B5866	41	38	3	0	scaffold_2	1503339	1603339
Aspergillus_fumigatus_B5866	37	15	22	0	scaffold_1	4441445	4541445
Aspergillus_fumigatus_B5866	39	35	4	0	scaffold_3	3683196	3783196
Aspergillus_fumigatus_B5866	37	35	2	0	scaffold_6	29761	129761
Aspergillus_fumigatus_B5866	41	32	9	0	scaffold_5	2296203	2396203
Aspergillus_fumigatus_B5866	50	44	6	0	scaffold_2	207502	307502
Aspergillus_fumigatus_B5866	28	24	4	0	scaffold_2	4594605	4694605
Aspergillus_fumigatus_B5866	48	42	6	0	scaffold_6	639222	739222
Aspergillus_fumigatus_B5866	36	34	2	0	scaffold_2	1295547	1395547
Aspergillus_fumigatus_B5866	39	36	3	0	scaffold_2	994811	1094811
Aspergillus_fumigatus_B5866	30	24	6	0	scaffold_3	730392	830392
Aspergillus_fumigatus_B5866	36	15	21	0	scaffold_3	578714	678714
Aspergillus_fumigatus_B5866	30	29	1	0	scaffold_4	715846	815846
Aspergillus_fumigatus_B5866	31	30	1	0	scaffold_3	3883438	3983438
Aspergillus_fumigatus_B5866	35	33	2	0	scaffold_1	1227590	1327590
Aspergillus_fumigatus_B5866	41	39	2	0	scaffold_3	2056391	2156391
Aspergillus_fumigatus_B5866	27	24	3	0	scaffold_1	1669781	1769781
Aspergillus_fumigatus_B5866	31	0	31	0	scaffold_1	4301069	4401069
Aspergillus_fumigatus_B5866	29	27	2	0	scaffold_4	1305003	1405003
Aspergillus_fumigatus_B5866	36	31	5	0	scaffold_1	1338244	1438244
Aspergillus_fumigatus_B5866	37	35	2	0	scaffold_8	1353138	1453138
Aspergillus_fumigatus_B5866	45	42	3	0	scaffold_4	863582	963582
Aspergillus_fumigatus_B5866	32	30	2	0	scaffold_3	2887296	2987296
Aspergillus_fumigatus_B5866	38	34	4	0	scaffold_7	424640	524640
Aspergillus_fumigatus_B5866	6	6	0	0	scaffold_6	1064980	1164980
Aspergillus_fumigatus_B5866	41	38	3	0	scaffold_1	2368157	2468157
Aspergillus_fumigatus_B5866	44	39	5	0	scaffold_8	305381	405381
Aspergillus_fumigatus_B5866	37	32	5	0	scaffold_1	4534179	4634179
Aspergillus_fumigatus_B5866	35	31	4	0	scaffold_4	1702045	1802045
Aspergillus_fumigatus_B5866	39	38	1	0	scaffold_7	1059748	1159748
Aspergillus_fumigatus_B5866	35	34	1	0	scaffold_2	3170702	3270702
Aspergillus_fumigatus_B5866	32	30	2	0	scaffold_1	1333687	1433687
Aspergillus_fumigatus_B5866	42	37	5	0	scaffold_8	311615	411615
Aspergillus_fumigatus_B5866	34	32	2	0	scaffold_1	1194364	1294364
Aspergillus_fumigatus_B5866	39	37	2	0	scaffold_4	806908	906908
Aspergillus_fumigatus_B5866	39	34	5	0	scaffold_4	3291807	3391807
Aspergillus_fumigatus_B5866	38	36	2	0	scaffold_2	3530249	3630249
Aspergillus_fumigatus_B5866	32	27	5	0	scaffold_6	2340922	2440922
Aspergillus_fumigatus_B5866	33	30	3	0	scaffold_3	1264688	1364688
Aspergillus_fumigatus_B5866	22	19	3	0	scaffold_8	738182	838182
Aspergillus_fumigatus_B5866	27	26	1	0	scaffold_6	1343725	1443725
Aspergillus_fumigatus_B5866	46	36	10	0	scaffold_1	4022692	4122692
Aspergillus_fumigatus_B5866	37	37	0	0	scaffold_5	3636204	3736204
Aspergillus_fumigatus_B5866	44	38	6	0	scaffold_6	3238931	3338931
Aspergillus_fumigatus_B5866	34	28	6	0	scaffold_8	391436	491436
Aspergillus_fumigatus_B5866	40	38	2	0	scaffold_1	2100998	2200998
Aspergillus_fumigatus_B5866	38	36	2	0	scaffold_2	2840325	2940325
Aspergillus_fumigatus_B5866	31	30	1	0	scaffold_1	920928	1020928
Aspergillus_fumigatus_B5866	31	31	0	0	scaffold_4	588170	688170
Aspergillus_fumigatus_B5866	29	28	1	0	scaffold_3	2838561	2938561
Aspergillus_fumigatus_B5866	31	30	1	0	scaffold_6	1989063	2089063
Aspergillus_fumigatus_B5866	48	37	11	0	scaffold_1	32301	132301
Aspergillus_fumigatus_B5866	43	40	3	0	scaffold_3	1465486	1565486
Aspergillus_fumigatus_B5866	42	40	2	0	scaffold_3	2046098	2146098
Aspergillus_fumigatus_B5866	39	34	5	0	scaffold_8	57690	157690
Aspergillus_fumigatus_B5866	37	29	8	0	scaffold_5	2908873	3008873
Aspergillus_fumigatus_B5866	33	32	1	0	scaffold_3	1079316	1179316
Aspergillus_fumigatus_B5866	39	33	6	0	scaffold_1	3868730	3968730
Aspergillus_fumigatus_B5866	36	34	2	0	scaffold_2	573341	673341
Aspergillus_fumigatus_B5866	36	34	2	0	scaffold_4	1232812	1332812
Aspergillus_fumigatus_B5866	42	37	5	0	scaffold_5	1080470	1180470
Aspergillus_fumigatus_B5866	48	43	5	0	scaffold_4	3688758	3788758
Aspergillus_fumigatus_B5866	38	37	1	0	scaffold_4	2851674	2951674
Aspergillus_fumigatus_B5866	36	35	1	0	scaffold_5	2672553	2772553
Aspergillus_fumigatus_B5866	40	37	3	0	scaffold_2	1007330	1107330
Aspergillus_fumigatus_B5866	37	31	6	0	scaffold_4	1642977	1742977
Aspergillus_fumigatus_B5866	42	38	4	0	scaffold_1	4571758	4671758
Aspergillus_fumigatus_B5866	36	35	1	0	scaffold_3	2948693	3048693
Aspergillus_fumigatus_B5866	37	11	26	0	scaffold_1	4203668	4303668
Aspergillus_fumigatus_B5866	37	37	0	0	scaffold_5	3140948	3240948
Aspergillus_fumigatus_B5866	39	36	3	0	scaffold_3	3015940	3115940
Aspergillus_fumigatus_B5866	35	32	3	0	scaffold_3	2480622	2580622
Aspergillus_fumigatus_B5866	18	14	4	0	scaffold_5	155655	255655
Aspergillus_fumigatus_B5866	42	34	8	0	scaffold_1	191925	291925
Aspergillus_fumigatus_B5866	36	33	3	0	scaffold_5	382123	482123
Aspergillus_fumigatus_B5866	42	35	7	0	scaffold_6	619199	719199
Aspergillus_fumigatus_B5866	39	34	5	0	scaffold_7	244829	344829
Aspergillus_fumigatus_B5866	38	34	4	0	scaffold_6	3167517	3267517
Aspergillus_fumigatus_B5866	41	38	3	0	scaffold_5	2029862	2129862
Aspergillus_fumigatus_B5866	35	32	3	0	scaffold_3	2525955	2625955
Aspergillus_fumigatus_B5866	44	37	7	0	scaffold_6	483907	583907
Aspergillus_fumigatus_B5866	33	32	1	0	scaffold_4	2971642	3071642
Aspergillus_fumigatus_B5866	32	25	7	0	scaffold_5	2951160	3051160
Aspergillus_fumigatus_B5866	39	37	2	0	scaffold_1	3678642	3778642
Aspergillus_fumigatus_B5866	39	36	3	0	scaffold_3	1006119	1106119
Aspergillus_fumigatus_B5866	37	34	3	0	scaffold_5	1943220	2043220
Aspergillus_fumigatus_B5866	43	4	39	0	scaffold_1	4385243	4485243
Aspergillus_fumigatus_B5866	26	25	1	0	scaffold_2	1909264	2009264
Aspergillus_fumigatus_B5866	38	37	1	0	scaffold_5	2665960	2765960
Aspergillus_fumigatus_B5866	38	35	3	0	scaffold_2	1744015	1844015
Aspergillus_fumigatus_B5866	43	42	1	0	scaffold_2	4187986	4287986
Aspergillus_fumigatus_B5866	37	36	1	0	scaffold_2	3965549	4065549
Aspergillus_fumigatus_B5866	38	38	0	0	scaffold_6	2854804	2954804
Aspergillus_fumigatus_B5866	35	34	1	0	scaffold_3	1404336	1504336
Aspergillus_fumigatus_B5866	35	33	2	0	scaffold_1	2520112	2620112
Aspergillus_fumigatus_B5866	32	30	2	0	scaffold_1	3516911	3616911
Aspergillus_fumigatus_B5866	45	38	7	0	scaffold_7	1351155	1451155
Aspergillus_fumigatus_B5866	35	29	6	0	scaffold_6	415311	515311
Aspergillus_fumigatus_B5866	44	41	3	0	scaffold_5	593292	693292
Aspergillus_fumigatus_B5866	46	40	6	0	scaffold_3	2256246	2356246
Aspergillus_fumigatus_B5866	44	38	6	0	scaffold_3	920556	1020556
Aspergillus_fumigatus_B5866	33	31	2	0	scaffold_2	3700062	3800062
Aspergillus_fumigatus_B5866	35	33	2	0	scaffold_3	3112122	3212122
Aspergillus_fumigatus_B5866	39	36	3	0	scaffold_6	1932451	2032451
Aspergillus_fumigatus_B5866	41	36	5	0	scaffold_4	3307200	3407200
Aspergillus_fumigatus_B5866	38	36	2	0	scaffold_2	2783504	2883504
Aspergillus_fumigatus_B5866	35	30	5	0	scaffold_5	2433054	2533054
Aspergillus_fumigatus_B5866	36	32	4	0	scaffold_1	1615171	1715171
Aspergillus_fumigatus_B5866	39	35	4	0	scaffold_7	17261	117261
Aspergillus_fumigatus_B5866	42	41	1	0	scaffold_4	921775	1021775
Aspergillus_fumigatus_B5866	38	35	3	0	scaffold_2	1819894	1919894
Aspergillus_fumigatus_B5866	19	12	7	0	scaffold_6	3438171	3538171
Aspergillus_fumigatus_B5866	41	40	1	0	scaffold_4	308625	408625
Aspergillus_fumigatus_B5866	45	39	6	0	scaffold_6	3228580	3328580
Aspergillus_fumigatus_B5866	33	29	4	0	scaffold_2	3375221	3475221
Aspergillus_fumigatus_B5866	38	36	2	0	scaffold_5	1350818	1450818
Aspergillus_fumigatus_B5866	41	38	3	0	scaffold_6	774934	874934
Aspergillus_fumigatus_B5866	45	40	5	0	scaffold_8	1569280	1669280
Aspergillus_fumigatus_B5866	37	31	6	0	scaffold_8	1070975	1170975
Aspergillus_fumigatus_B5866	30	26	4	0	scaffold_4	2132715	2232715
Aspergillus_fumigatus_B5866	32	32	0	0	scaffold_6	2745031	2845031
Aspergillus_fumigatus_B5866	39	34	5	0	scaffold_3	3178194	3278194
Aspergillus_fumigatus_B5866	30	28	2	0	scaffold_1	2977903	3077903
Aspergillus_fumigatus_B5866	35	26	9	0	scaffold_5	2324566	2424566
Aspergillus_fumigatus_B5866	45	42	3	0	scaffold_3	496991	596991
Aspergillus_fumigatus_B5866	30	26	4	0	scaffold_1	3575782	3675782
Aspergillus_fumigatus_B5866	38	33	5	0	scaffold_4	354302	454302
Aspergillus_fumigatus_B5866	33	32	1	0	scaffold_2	2865760	2965760
Aspergillus_fumigatus_B5866	42	37	5	0	scaffold_1	307517	407517
Aspergillus_fumigatus_B5866	14	14	0	0	scaffold_3	1133393	1233393
Aspergillus_fumigatus_B5866	38	26	12	0	scaffold_3	6071	106071
Aspergillus_fumigatus_B5866	44	38	6	0	scaffold_3	3425315	3525315
Aspergillus_fumigatus_B5866	35	30	5	0	scaffold_1	3822336	3922336
Aspergillus_fumigatus_B5866	37	36	1	0	scaffold_2	1031754	1131754
Aspergillus_fumigatus_B5866	33	30	3	0	scaffold_2	3725819	3825819
Aspergillus_fumigatus_B5866	36	35	1	0	scaffold_5	1675330	1775330
Aspergillus_fumigatus_B5866	41	40	1	0	scaffold_5	2648868	2748868
Aspergillus_fumigatus_B5866	36	31	5	0	scaffold_3	1845268	1945268
Aspergillus_fumigatus_B5866	35	32	3	0	scaffold_5	920991	1020991
Aspergillus_fumigatus_B5866	47	42	5	0	scaffold_3	2231023	2331023
Aspergillus_fumigatus_B5866	14	13	1	0	scaffold_1	1801631	1901631
