STRAIN	TOTAL	CORE	ACCESSORY	SINGLETON	CHROM	START	END
Aspergillus_fumigatus_B5960_CDC_29	13	13	0	0	scaffold_2	2723317	2773317
Aspergillus_fumigatus_B5960_CDC_29	21	18	3	0	scaffold_8	120694	170694
Aspergillus_fumigatus_B5960_CDC_29	17	14	3	0	scaffold_4	130462	180462
Aspergillus_fumigatus_B5960_CDC_29	19	17	2	0	scaffold_7	1275354	1325354
Aspergillus_fumigatus_B5960_CDC_29	20	19	1	0	scaffold_4	3216022	3266022
Aspergillus_fumigatus_B5960_CDC_29	18	15	3	0	scaffold_6	2441708	2491708
Aspergillus_fumigatus_B5960_CDC_29	17	17	0	0	scaffold_2	2785027	2835027
Aspergillus_fumigatus_B5960_CDC_29	19	19	0	0	scaffold_1	2242844	2292844
Aspergillus_fumigatus_B5960_CDC_29	16	16	0	0	scaffold_5	609981	659981
Aspergillus_fumigatus_B5960_CDC_29	20	16	4	0	scaffold_3	2651956	2701956
Aspergillus_fumigatus_B5960_CDC_29	20	19	1	0	scaffold_4	3212072	3262072
Aspergillus_fumigatus_B5960_CDC_29	21	20	1	0	scaffold_3	355633	405633
Aspergillus_fumigatus_B5960_CDC_29	21	17	4	0	scaffold_2	3847943	3897943
Aspergillus_fumigatus_B5960_CDC_29	20	16	4	0	scaffold_7	392583	442583
Aspergillus_fumigatus_B5960_CDC_29	17	14	3	0	scaffold_2	4641064	4691064
Aspergillus_fumigatus_B5960_CDC_29	18	16	2	0	scaffold_5	1712832	1762832
Aspergillus_fumigatus_B5960_CDC_29	19	17	2	0	scaffold_8	1057719	1107719
Aspergillus_fumigatus_B5960_CDC_29	13	8	5	0	scaffold_4	2459024	2509024
Aspergillus_fumigatus_B5960_CDC_29	24	22	2	0	scaffold_7	1762531	1812531
Aspergillus_fumigatus_B5960_CDC_29	22	20	2	0	scaffold_2	3627154	3677154
Aspergillus_fumigatus_B5960_CDC_29	23	21	2	0	scaffold_2	3622638	3672638
Aspergillus_fumigatus_B5960_CDC_29	21	20	1	0	scaffold_8	863906	913906
Aspergillus_fumigatus_B5960_CDC_29	10	10	0	0	scaffold_8	676995	726995
Aspergillus_fumigatus_B5960_CDC_29	29	23	6	0	scaffold_5	3708912	3758912
Aspergillus_fumigatus_B5960_CDC_29	22	18	4	0	scaffold_1	4230152	4280152
Aspergillus_fumigatus_B5960_CDC_29	15	14	1	0	scaffold_5	2994425	3044425
Aspergillus_fumigatus_B5960_CDC_29	17	12	5	0	scaffold_1	3534025	3584025
Aspergillus_fumigatus_B5960_CDC_29	20	18	2	0	scaffold_2	2413414	2463414
Aspergillus_fumigatus_B5960_CDC_29	26	18	8	0	scaffold_2	2589827	2639827
Aspergillus_fumigatus_B5960_CDC_29	20	17	3	0	scaffold_8	418878	468878
Aspergillus_fumigatus_B5960_CDC_29	13	12	1	0	scaffold_5	1892188	1942188
Aspergillus_fumigatus_B5960_CDC_29	9	7	2	0	scaffold_2	4664927	4714927
Aspergillus_fumigatus_B5960_CDC_29	17	17	0	0	scaffold_2	956156	1006156
Aspergillus_fumigatus_B5960_CDC_29	23	17	6	0	scaffold_5	23680	73680
Aspergillus_fumigatus_B5960_CDC_29	17	16	1	0	scaffold_6	127486	177486
Aspergillus_fumigatus_B5960_CDC_29	19	16	3	0	scaffold_6	3036360	3086360
Aspergillus_fumigatus_B5960_CDC_29	15	14	1	0	scaffold_2	3743889	3793889
Aspergillus_fumigatus_B5960_CDC_29	11	10	1	0	scaffold_7	670856	720856
Aspergillus_fumigatus_B5960_CDC_29	17	15	2	0	scaffold_2	499265	549265
Aspergillus_fumigatus_B5960_CDC_29	16	14	2	0	scaffold_8	591700	641700
Aspergillus_fumigatus_B5960_CDC_29	15	14	1	0	scaffold_6	3313486	3363486
Aspergillus_fumigatus_B5960_CDC_29	19	19	0	0	scaffold_2	1946240	1996240
Aspergillus_fumigatus_B5960_CDC_29	21	21	0	0	scaffold_4	1851248	1901248
Aspergillus_fumigatus_B5960_CDC_29	14	13	1	0	scaffold_7	192896	242896
Aspergillus_fumigatus_B5960_CDC_29	18	17	1	0	scaffold_5	679943	729943
Aspergillus_fumigatus_B5960_CDC_29	13	11	2	0	scaffold_1	1822827	1872827
Aspergillus_fumigatus_B5960_CDC_29	18	15	3	0	scaffold_1	1474595	1524595
Aspergillus_fumigatus_B5960_CDC_29	18	15	3	0	scaffold_1	1702254	1752254
Aspergillus_fumigatus_B5960_CDC_29	12	12	0	0	scaffold_6	2823410	2873410
Aspergillus_fumigatus_B5960_CDC_29	22	20	2	0	scaffold_2	3928354	3978354
Aspergillus_fumigatus_B5960_CDC_29	20	20	0	0	scaffold_5	522411	572411
Aspergillus_fumigatus_B5960_CDC_29	14	14	0	0	scaffold_5	1363013	1413013
Aspergillus_fumigatus_B5960_CDC_29	17	15	2	0	scaffold_1	405915	455915
Aspergillus_fumigatus_B5960_CDC_29	18	16	2	0	scaffold_3	792147	842147
Aspergillus_fumigatus_B5960_CDC_29	15	15	0	0	scaffold_1	2784169	2834169
Aspergillus_fumigatus_B5960_CDC_29	19	17	2	0	scaffold_4	3238478	3288478
Aspergillus_fumigatus_B5960_CDC_29	26	24	2	0	scaffold_4	2306569	2356569
Aspergillus_fumigatus_B5960_CDC_29	13	12	1	0	scaffold_6	107966	157966
Aspergillus_fumigatus_B5960_CDC_29	18	16	2	0	scaffold_2	3866758	3916758
Aspergillus_fumigatus_B5960_CDC_29	16	15	1	0	scaffold_1	1331397	1381397
Aspergillus_fumigatus_B5960_CDC_29	19	16	3	0	scaffold_1	4207829	4257829
Aspergillus_fumigatus_B5960_CDC_29	23	17	6	0	scaffold_3	246731	296731
Aspergillus_fumigatus_B5960_CDC_29	13	13	0	0	scaffold_5	1327249	1377249
Aspergillus_fumigatus_B5960_CDC_29	15	14	1	0	scaffold_7	583492	633492
Aspergillus_fumigatus_B5960_CDC_29	20	12	8	0	scaffold_2	7034	57034
Aspergillus_fumigatus_B5960_CDC_29	17	15	2	0	scaffold_4	1936680	1986680
Aspergillus_fumigatus_B5960_CDC_29	25	23	2	0	scaffold_1	4689155	4739155
Aspergillus_fumigatus_B5960_CDC_29	20	17	3	0	scaffold_1	4092625	4142625
Aspergillus_fumigatus_B5960_CDC_29	19	19	0	0	scaffold_3	1722894	1772894
Aspergillus_fumigatus_B5960_CDC_29	17	15	2	0	scaffold_4	1115661	1165661
Aspergillus_fumigatus_B5960_CDC_29	24	19	5	0	scaffold_1	136185	186185
Aspergillus_fumigatus_B5960_CDC_29	23	21	2	0	scaffold_2	3103631	3153631
Aspergillus_fumigatus_B5960_CDC_29	19	18	1	0	scaffold_2	2810643	2860643
Aspergillus_fumigatus_B5960_CDC_29	20	18	2	0	scaffold_2	3238592	3288592
Aspergillus_fumigatus_B5960_CDC_29	17	15	2	0	scaffold_8	26917	76917
Aspergillus_fumigatus_B5960_CDC_29	18	18	0	0	scaffold_4	305708	355708
Aspergillus_fumigatus_B5960_CDC_29	20	20	0	0	scaffold_1	2662080	2712080
Aspergillus_fumigatus_B5960_CDC_29	16	16	0	0	scaffold_2	1205897	1255897
Aspergillus_fumigatus_B5960_CDC_29	16	15	1	0	scaffold_1	1779511	1829511
Aspergillus_fumigatus_B5960_CDC_29	19	15	4	0	scaffold_3	3614859	3664859
Aspergillus_fumigatus_B5960_CDC_29	8	6	2	0	scaffold_7	207834	257834
Aspergillus_fumigatus_B5960_CDC_29	19	18	1	0	scaffold_6	3259891	3309891
Aspergillus_fumigatus_B5960_CDC_29	13	12	1	0	scaffold_2	3734206	3784206
Aspergillus_fumigatus_B5960_CDC_29	25	23	2	0	scaffold_1	2879361	2929361
Aspergillus_fumigatus_B5960_CDC_29	13	13	0	0	scaffold_8	663946	713946
Aspergillus_fumigatus_B5960_CDC_29	19	15	4	0	scaffold_6	627538	677538
Aspergillus_fumigatus_B5960_CDC_29	24	23	1	0	scaffold_6	1360800	1410800
Aspergillus_fumigatus_B5960_CDC_29	16	7	9	0	scaffold_3	562491	612491
Aspergillus_fumigatus_B5960_CDC_29	20	19	1	0	scaffold_1	1229453	1279453
Aspergillus_fumigatus_B5960_CDC_29	21	20	1	0	scaffold_1	989531	1039531
Aspergillus_fumigatus_B5960_CDC_29	18	16	2	0	scaffold_1	820962	870962
Aspergillus_fumigatus_B5960_CDC_29	14	12	2	0	scaffold_2	4180610	4230610
Aspergillus_fumigatus_B5960_CDC_29	26	23	3	0	scaffold_8	268000	318000
Aspergillus_fumigatus_B5960_CDC_29	15	15	0	0	scaffold_6	2731621	2781621
Aspergillus_fumigatus_B5960_CDC_29	22	18	4	0	scaffold_7	540168	590168
Aspergillus_fumigatus_B5960_CDC_29	26	26	0	0	scaffold_6	3657693	3707693
Aspergillus_fumigatus_B5960_CDC_29	19	18	1	0	scaffold_4	3824387	3874387
Aspergillus_fumigatus_B5960_CDC_29	10	8	2	0	scaffold_3	1190408	1240408
Aspergillus_fumigatus_B5960_CDC_29	18	14	4	0	scaffold_3	668133	718133
Aspergillus_fumigatus_B5960_CDC_29	17	15	2	0	scaffold_6	3345761	3395761
Aspergillus_fumigatus_B5960_CDC_29	19	14	5	0	scaffold_6	2200416	2250416
Aspergillus_fumigatus_B5960_CDC_29	22	15	7	0	scaffold_3	3517490	3567490
Aspergillus_fumigatus_B5960_CDC_29	24	23	1	0	scaffold_2	2391794	2441794
Aspergillus_fumigatus_B5960_CDC_29	25	24	1	0	scaffold_7	1554856	1604856
Aspergillus_fumigatus_B5960_CDC_29	18	16	2	0	scaffold_2	1419258	1469258
Aspergillus_fumigatus_B5960_CDC_29	17	17	0	0	scaffold_5	1075574	1125574
Aspergillus_fumigatus_B5960_CDC_29	21	19	2	0	scaffold_8	1319187	1369187
Aspergillus_fumigatus_B5960_CDC_29	20	18	2	0	scaffold_3	1231316	1281316
Aspergillus_fumigatus_B5960_CDC_29	21	18	3	0	scaffold_7	448179	498179
Aspergillus_fumigatus_B5960_CDC_29	21	20	1	0	scaffold_4	812058	862058
Aspergillus_fumigatus_B5960_CDC_29	25	24	1	0	scaffold_4	1747560	1797560
Aspergillus_fumigatus_B5960_CDC_29	20	16	4	0	scaffold_2	2215554	2265554
Aspergillus_fumigatus_B5960_CDC_29	19	19	0	0	scaffold_5	2091007	2141007
Aspergillus_fumigatus_B5960_CDC_29	17	14	3	0	scaffold_6	3040563	3090563
Aspergillus_fumigatus_B5960_CDC_29	16	15	1	0	scaffold_2	2936712	2986712
Aspergillus_fumigatus_B5960_CDC_29	14	13	1	0	scaffold_6	1462145	1512145
Aspergillus_fumigatus_B5960_CDC_29	17	16	1	0	scaffold_2	858238	908238
Aspergillus_fumigatus_B5960_CDC_29	23	17	6	0	scaffold_1	58260	108260
Aspergillus_fumigatus_B5960_CDC_29	20	18	2	0	scaffold_5	2221859	2271859
Aspergillus_fumigatus_B5960_CDC_29	24	24	0	0	scaffold_5	997857	1047857
Aspergillus_fumigatus_B5960_CDC_29	24	19	5	0	scaffold_1	3970001	4020001
Aspergillus_fumigatus_B5960_CDC_29	20	19	1	0	scaffold_2	2272315	2322315
Aspergillus_fumigatus_B5960_CDC_29	19	11	8	0	scaffold_1	4276776	4326776
Aspergillus_fumigatus_B5960_CDC_29	17	14	3	0	scaffold_7	502862	552862
Aspergillus_fumigatus_B5960_CDC_29	18	16	2	0	scaffold_3	1348846	1398846
Aspergillus_fumigatus_B5960_CDC_29	18	18	0	0	scaffold_2	2902183	2952183
Aspergillus_fumigatus_B5960_CDC_29	22	19	3	0	scaffold_4	2840529	2890529
Aspergillus_fumigatus_B5960_CDC_29	22	22	0	0	scaffold_6	1809516	1859516
Aspergillus_fumigatus_B5960_CDC_29	19	15	4	0	scaffold_4	2506062	2556062
Aspergillus_fumigatus_B5960_CDC_29	21	19	2	0	scaffold_1	255510	305510
Aspergillus_fumigatus_B5960_CDC_29	9	0	9	0	scaffold_7	236790	286790
Aspergillus_fumigatus_B5960_CDC_29	17	14	3	0	scaffold_8	377722	427722
Aspergillus_fumigatus_B5960_CDC_29	21	20	1	0	scaffold_4	1070742	1120742
Aspergillus_fumigatus_B5960_CDC_29	18	17	1	0	scaffold_2	3544886	3594886
Aspergillus_fumigatus_B5960_CDC_29	22	22	0	0	scaffold_1	447801	497801
Aspergillus_fumigatus_B5960_CDC_29	26	24	2	0	scaffold_6	2559481	2609481
Aspergillus_fumigatus_B5960_CDC_29	17	15	2	0	scaffold_1	3068355	3118355
Aspergillus_fumigatus_B5960_CDC_29	16	14	2	0	scaffold_8	471453	521453
Aspergillus_fumigatus_B5960_CDC_29	16	14	2	0	scaffold_1	3576625	3626625
Aspergillus_fumigatus_B5960_CDC_29	6	4	2	0	scaffold_3	1949987	1999987
Aspergillus_fumigatus_B5960_CDC_29	18	18	0	0	scaffold_2	2898797	2948797
Aspergillus_fumigatus_B5960_CDC_29	21	20	1	0	scaffold_6	1643272	1693272
Aspergillus_fumigatus_B5960_CDC_29	23	19	4	0	scaffold_7	55278	105278
Aspergillus_fumigatus_B5960_CDC_29	18	16	2	0	scaffold_2	3865770	3915770
Aspergillus_fumigatus_B5960_CDC_29	22	20	2	0	scaffold_7	1481046	1531046
Aspergillus_fumigatus_B5960_CDC_29	14	13	1	0	scaffold_3	2818144	2868144
Aspergillus_fumigatus_B5960_CDC_29	19	17	2	0	scaffold_4	3483954	3533954
Aspergillus_fumigatus_B5960_CDC_29	16	16	0	0	scaffold_2	4109175	4159175
Aspergillus_fumigatus_B5960_CDC_29	21	19	2	0	scaffold_3	3368601	3418601
Aspergillus_fumigatus_B5960_CDC_29	16	13	3	0	scaffold_6	191686	241686
Aspergillus_fumigatus_B5960_CDC_29	21	17	4	0	scaffold_1	3336344	3386344
Aspergillus_fumigatus_B5960_CDC_29	20	17	3	0	scaffold_2	2222049	2272049
Aspergillus_fumigatus_B5960_CDC_29	7	7	0	0	scaffold_4	2421295	2471295
Aspergillus_fumigatus_B5960_CDC_29	20	17	3	0	scaffold_3	751349	801349
Aspergillus_fumigatus_B5960_CDC_29	19	19	0	0	scaffold_6	2067744	2117744
Aspergillus_fumigatus_B5960_CDC_29	20	19	1	0	scaffold_2	2071566	2121566
Aspergillus_fumigatus_B5960_CDC_29	23	22	1	0	scaffold_3	2620426	2670426
Aspergillus_fumigatus_B5960_CDC_29	25	23	2	0	scaffold_3	3769807	3819807
Aspergillus_fumigatus_B5960_CDC_29	22	20	2	0	scaffold_3	2252652	2302652
Aspergillus_fumigatus_B5960_CDC_29	22	19	3	0	scaffold_5	3604551	3654551
Aspergillus_fumigatus_B5960_CDC_29	21	18	3	0	scaffold_8	560993	610993
Aspergillus_fumigatus_B5960_CDC_29	22	22	0	0	scaffold_5	2663970	2713970
Aspergillus_fumigatus_B5960_CDC_29	21	19	2	0	scaffold_6	2337384	2387384
Aspergillus_fumigatus_B5960_CDC_29	18	17	1	0	scaffold_6	341450	391450
Aspergillus_fumigatus_B5960_CDC_29	22	18	4	0	scaffold_6	3527357	3577357
Aspergillus_fumigatus_B5960_CDC_29	16	16	0	0	scaffold_6	3304673	3354673
Aspergillus_fumigatus_B5960_CDC_29	18	18	0	0	scaffold_4	1257803	1307803
Aspergillus_fumigatus_B5960_CDC_29	23	23	0	0	scaffold_4	831684	881684
Aspergillus_fumigatus_B5960_CDC_29	19	18	1	0	scaffold_1	3595340	3645340
Aspergillus_fumigatus_B5960_CDC_29	10	0	10	0	scaffold_7	239615	289615
Aspergillus_fumigatus_B5960_CDC_29	18	14	4	0	scaffold_3	1854127	1904127
Aspergillus_fumigatus_B5960_CDC_29	23	19	4	0	scaffold_5	36551	86551
Aspergillus_fumigatus_B5960_CDC_29	11	11	0	0	scaffold_4	2404734	2454734
Aspergillus_fumigatus_B5960_CDC_29	21	18	3	0	scaffold_2	4569021	4619021
Aspergillus_fumigatus_B5960_CDC_29	7	4	3	0	scaffold_8	740890	790890
Aspergillus_fumigatus_B5960_CDC_29	30	23	7	0	scaffold_2	2627218	2677218
Aspergillus_fumigatus_B5960_CDC_29	16	16	0	0	scaffold_7	1057031	1107031
Aspergillus_fumigatus_B5960_CDC_29	16	15	1	0	scaffold_2	4025027	4075027
Aspergillus_fumigatus_B5960_CDC_29	19	16	3	0	scaffold_3	746904	796904
Aspergillus_fumigatus_B5960_CDC_29	18	14	4	0	scaffold_4	3106927	3156927
Aspergillus_fumigatus_B5960_CDC_29	16	14	2	0	scaffold_8	28133	78133
Aspergillus_fumigatus_B5960_CDC_29	16	14	2	0	scaffold_6	1470185	1520185
Aspergillus_fumigatus_B5960_CDC_29	25	24	1	0	scaffold_6	2302370	2352370
Aspergillus_fumigatus_B5960_CDC_29	16	15	1	0	scaffold_5	579551	629551
Aspergillus_fumigatus_B5960_CDC_29	9	6	3	0	scaffold_7	901333	951333
Aspergillus_fumigatus_B5960_CDC_29	18	18	0	0	scaffold_5	2122718	2172718
Aspergillus_fumigatus_B5960_CDC_29	16	15	1	0	scaffold_6	3379177	3429177
Aspergillus_fumigatus_B5960_CDC_29	24	18	6	0	scaffold_6	3698311	3748311
Aspergillus_fumigatus_B5960_CDC_29	16	14	2	0	scaffold_7	1379254	1429254
Aspergillus_fumigatus_B5960_CDC_29	18	17	1	0	scaffold_4	1188702	1238702
Aspergillus_fumigatus_B5960_CDC_29	18	15	3	0	scaffold_2	4633023	4683023
Aspergillus_fumigatus_B5960_CDC_29	26	21	5	0	scaffold_3	3464769	3514769
Aspergillus_fumigatus_B5960_CDC_29	20	16	4	0	scaffold_4	886388	936388
Aspergillus_fumigatus_B5960_CDC_29	18	18	0	0	scaffold_1	2256879	2306879
Aspergillus_fumigatus_B5960_CDC_29	5	4	1	0	scaffold_4	2443456	2493456
Aspergillus_fumigatus_B5960_CDC_29	15	14	1	0	scaffold_6	2517223	2567223
Aspergillus_fumigatus_B5960_CDC_29	18	15	3	0	scaffold_6	620330	670330
Aspergillus_fumigatus_B5960_CDC_29	15	14	1	0	scaffold_3	1292912	1342912
Aspergillus_fumigatus_B5960_CDC_29	15	14	1	0	scaffold_2	3196446	3246446
Aspergillus_fumigatus_B5960_CDC_29	18	17	1	0	scaffold_5	3004854	3054854
Aspergillus_fumigatus_B5960_CDC_29	18	15	3	0	scaffold_1	267277	317277
Aspergillus_fumigatus_B5960_CDC_29	18	18	0	0	scaffold_4	3340518	3390518
Aspergillus_fumigatus_B5960_CDC_29	18	17	1	0	scaffold_2	1252380	1302380
Aspergillus_fumigatus_B5960_CDC_29	19	14	5	0	scaffold_1	3685125	3735125
Aspergillus_fumigatus_B5960_CDC_29	14	13	1	0	scaffold_4	2518046	2568046
Aspergillus_fumigatus_B5960_CDC_29	19	19	0	0	scaffold_3	1726339	1776339
Aspergillus_fumigatus_B5960_CDC_29	22	19	3	0	scaffold_3	214254	264254
Aspergillus_fumigatus_B5960_CDC_29	17	15	2	0	scaffold_6	1282527	1332527
Aspergillus_fumigatus_B5960_CDC_29	18	16	2	0	scaffold_5	2948993	2998993
Aspergillus_fumigatus_B5960_CDC_29	14	10	4	0	scaffold_4	237165	287165
Aspergillus_fumigatus_B5960_CDC_29	21	17	4	0	scaffold_4	2090918	2140918
Aspergillus_fumigatus_B5960_CDC_29	21	20	1	0	scaffold_2	2268708	2318708
Aspergillus_fumigatus_B5960_CDC_29	23	17	6	0	scaffold_1	163699	213699
Aspergillus_fumigatus_B5960_CDC_29	15	13	2	0	scaffold_1	3667262	3717262
Aspergillus_fumigatus_B5960_CDC_29	19	15	4	0	scaffold_6	626209	676209
Aspergillus_fumigatus_B5960_CDC_29	21	21	0	0	scaffold_2	1279043	1329043
Aspergillus_fumigatus_B5960_CDC_29	19	17	1	1	scaffold_3	1416510	1466510
Aspergillus_fumigatus_B5960_CDC_29	15	14	1	0	scaffold_6	2129347	2179347
Aspergillus_fumigatus_B5960_CDC_29	20	19	1	0	scaffold_3	2741998	2791998
Aspergillus_fumigatus_B5960_CDC_29	16	15	1	0	scaffold_1	2765566	2815566
Aspergillus_fumigatus_B5960_CDC_29	24	18	6	0	scaffold_3	243185	293185
Aspergillus_fumigatus_B5960_CDC_29	19	18	1	0	scaffold_5	842518	892518
Aspergillus_fumigatus_B5960_CDC_29	17	15	2	0	scaffold_1	2842079	2892079
Aspergillus_fumigatus_B5960_CDC_29	22	20	2	0	scaffold_6	827234	877234
Aspergillus_fumigatus_B5960_CDC_29	22	19	3	0	scaffold_3	9395	59395
Aspergillus_fumigatus_B5960_CDC_29	20	18	2	0	scaffold_4	695195	745195
Aspergillus_fumigatus_B5960_CDC_29	14	13	1	0	scaffold_3	2823085	2873085
Aspergillus_fumigatus_B5960_CDC_29	19	18	1	0	scaffold_3	150191	200191
Aspergillus_fumigatus_B5960_CDC_29	10	10	0	0	scaffold_1	3123596	3173596
Aspergillus_fumigatus_B5960_CDC_29	18	15	3	0	scaffold_5	2827427	2877427
Aspergillus_fumigatus_B5960_CDC_29	21	20	1	0	scaffold_7	1211519	1261519
Aspergillus_fumigatus_B5960_CDC_29	21	19	2	0	scaffold_3	146981	196981
Aspergillus_fumigatus_B5960_CDC_29	15	15	0	0	scaffold_1	2792122	2842122
Aspergillus_fumigatus_B5960_CDC_29	20	20	0	0	scaffold_2	419145	469145
Aspergillus_fumigatus_B5960_CDC_29	29	21	8	0	scaffold_8	261586	311586
Aspergillus_fumigatus_B5960_CDC_29	28	27	1	0	scaffold_3	3841864	3891864
Aspergillus_fumigatus_B5960_CDC_29	17	17	0	0	scaffold_5	1457898	1507898
Aspergillus_fumigatus_B5960_CDC_29	20	19	1	0	scaffold_2	1518901	1568901
Aspergillus_fumigatus_B5960_CDC_29	14	12	2	0	scaffold_5	1883941	1933941
Aspergillus_fumigatus_B5960_CDC_29	10	6	4	0	scaffold_1	2077969	2127969
Aspergillus_fumigatus_B5960_CDC_29	16	13	3	0	scaffold_8	1089748	1139748
Aspergillus_fumigatus_B5960_CDC_29	27	21	6	0	scaffold_1	4124433	4174433
Aspergillus_fumigatus_B5960_CDC_29	23	20	3	0	scaffold_3	2261245	2311245
Aspergillus_fumigatus_B5960_CDC_29	19	16	3	0	scaffold_6	1501097	1551097
Aspergillus_fumigatus_B5960_CDC_29	24	16	8	0	scaffold_2	2584260	2634260
Aspergillus_fumigatus_B5960_CDC_29	21	19	2	0	scaffold_1	2463129	2513129
Aspergillus_fumigatus_B5960_CDC_29	22	21	1	0	scaffold_2	4231757	4281757
Aspergillus_fumigatus_B5960_CDC_29	19	18	1	0	scaffold_2	2259428	2309428
Aspergillus_fumigatus_B5960_CDC_29	15	15	0	0	scaffold_4	2978067	3028067
Aspergillus_fumigatus_B5960_CDC_29	19	19	0	0	scaffold_1	3162606	3212606
Aspergillus_fumigatus_B5960_CDC_29	18	18	0	0	scaffold_7	795265	845265
Aspergillus_fumigatus_B5960_CDC_29	24	20	4	0	scaffold_7	1586327	1636327
Aspergillus_fumigatus_B5960_CDC_29	21	19	2	0	scaffold_4	2193536	2243536
Aspergillus_fumigatus_B5960_CDC_29	18	16	2	0	scaffold_3	3113686	3163686
Aspergillus_fumigatus_B5960_CDC_29	17	15	2	0	scaffold_3	787515	837515
Aspergillus_fumigatus_B5960_CDC_29	16	15	1	0	scaffold_7	1010593	1060593
Aspergillus_fumigatus_B5960_CDC_29	22	17	5	0	scaffold_5	3314722	3364722
Aspergillus_fumigatus_B5960_CDC_29	13	13	0	0	scaffold_2	970171	1020171
Aspergillus_fumigatus_B5960_CDC_29	25	19	6	0	scaffold_5	3642286	3692286
Aspergillus_fumigatus_B5960_CDC_29	16	15	1	0	scaffold_1	2032316	2082316
Aspergillus_fumigatus_B5960_CDC_29	19	17	2	0	scaffold_3	317765	367765
Aspergillus_fumigatus_B5960_CDC_29	18	15	3	0	scaffold_3	48900	98900
Aspergillus_fumigatus_B5960_CDC_29	20	17	3	0	scaffold_4	3606366	3656366
Aspergillus_fumigatus_B5960_CDC_29	16	16	0	0	scaffold_3	1676654	1726654
Aspergillus_fumigatus_B5960_CDC_29	20	17	3	0	scaffold_8	349323	399323
Aspergillus_fumigatus_B5960_CDC_29	24	21	3	0	scaffold_2	2380233	2430233
Aspergillus_fumigatus_B5960_CDC_29	16	15	1	0	scaffold_2	831678	881678
Aspergillus_fumigatus_B5960_CDC_29	19	18	1	0	scaffold_3	1990486	2040486
Aspergillus_fumigatus_B5960_CDC_29	5	5	0	0	scaffold_1	1902524	1952524
Aspergillus_fumigatus_B5960_CDC_29	20	20	0	0	scaffold_2	813731	863731
Aspergillus_fumigatus_B5960_CDC_29	21	21	0	0	scaffold_7	1309416	1359416
Aspergillus_fumigatus_B5960_CDC_29	16	12	4	0	scaffold_5	3269173	3319173
Aspergillus_fumigatus_B5960_CDC_29	20	20	0	0	scaffold_5	2258256	2308256
Aspergillus_fumigatus_B5960_CDC_29	20	14	6	0	scaffold_1	4601009	4651009
Aspergillus_fumigatus_B5960_CDC_29	28	24	4	0	scaffold_7	1573022	1623022
Aspergillus_fumigatus_B5960_CDC_29	15	15	0	0	scaffold_5	3209254	3259254
Aspergillus_fumigatus_B5960_CDC_29	20	19	1	0	scaffold_1	528153	578153
Aspergillus_fumigatus_B5960_CDC_29	17	16	1	0	scaffold_4	1291471	1341471
Aspergillus_fumigatus_B5960_CDC_29	22	21	1	0	scaffold_1	477110	527110
Aspergillus_fumigatus_B5960_CDC_29	20	18	2	0	scaffold_6	226627	276627
Aspergillus_fumigatus_B5960_CDC_29	21	20	1	0	scaffold_8	921706	971706
Aspergillus_fumigatus_B5960_CDC_29	12	12	0	0	scaffold_1	2701030	2751030
Aspergillus_fumigatus_B5960_CDC_29	19	18	1	0	scaffold_2	942095	992095
Aspergillus_fumigatus_B5960_CDC_29	15	12	3	0	scaffold_7	1396769	1446769
Aspergillus_fumigatus_B5960_CDC_29	20	20	0	0	scaffold_3	1057014	1107014
Aspergillus_fumigatus_B5960_CDC_29	13	12	1	0	scaffold_3	1638904	1688904
Aspergillus_fumigatus_B5960_CDC_29	22	20	2	0	scaffold_5	470701	520701
Aspergillus_fumigatus_B5960_CDC_29	23	23	0	0	scaffold_3	823640	873640
Aspergillus_fumigatus_B5960_CDC_29	9	9	0	0	scaffold_8	683676	733676
Aspergillus_fumigatus_B5960_CDC_29	5	5	0	0	scaffold_8	692469	742469
Aspergillus_fumigatus_B5960_CDC_29	19	17	2	0	scaffold_2	2088707	2138707
Aspergillus_fumigatus_B5960_CDC_29	20	19	1	0	scaffold_2	1259325	1309325
Aspergillus_fumigatus_B5960_CDC_29	18	18	0	0	scaffold_6	1553653	1603653
Aspergillus_fumigatus_B5960_CDC_29	20	18	2	0	scaffold_3	1530233	1580233
Aspergillus_fumigatus_B5960_CDC_29	18	18	0	0	scaffold_6	3113103	3163103
Aspergillus_fumigatus_B5960_CDC_29	19	18	1	0	scaffold_6	2043946	2093946
Aspergillus_fumigatus_B5960_CDC_29	20	16	4	0	scaffold_4	2695036	2745036
Aspergillus_fumigatus_B5960_CDC_29	18	17	1	0	scaffold_2	1500109	1550109
Aspergillus_fumigatus_B5960_CDC_29	13	13	0	0	scaffold_2	619545	669545
Aspergillus_fumigatus_B5960_CDC_29	22	20	2	0	scaffold_8	286902	336902
Aspergillus_fumigatus_B5960_CDC_29	23	19	4	0	scaffold_6	25210	75210
Aspergillus_fumigatus_B5960_CDC_29	12	11	1	0	scaffold_1	1828572	1878572
Aspergillus_fumigatus_B5960_CDC_29	4	4	0	0	scaffold_3	1150260	1200260
Aspergillus_fumigatus_B5960_CDC_29	21	20	1	0	scaffold_4	1082594	1132594
Aspergillus_fumigatus_B5960_CDC_29	15	10	5	0	scaffold_4	201237	251237
Aspergillus_fumigatus_B5960_CDC_29	19	17	2	0	scaffold_3	3089131	3139131
Aspergillus_fumigatus_B5960_CDC_29	20	19	1	0	scaffold_6	3211464	3261464
Aspergillus_fumigatus_B5960_CDC_29	17	17	0	0	scaffold_1	617690	667690
Aspergillus_fumigatus_B5960_CDC_29	20	16	4	0	scaffold_3	2651377	2701377
Aspergillus_fumigatus_B5960_CDC_29	21	19	2	0	scaffold_2	2455266	2505266
Aspergillus_fumigatus_B5960_CDC_29	8	6	2	0	scaffold_7	857610	907610
Aspergillus_fumigatus_B5960_CDC_29	17	17	0	0	scaffold_2	3475998	3525998
Aspergillus_fumigatus_B5960_CDC_29	25	23	2	0	scaffold_2	4457494	4507494
Aspergillus_fumigatus_B5960_CDC_29	17	15	2	0	scaffold_4	2131607	2181607
Aspergillus_fumigatus_B5960_CDC_29	15	11	4	0	scaffold_6	183699	233699
Aspergillus_fumigatus_B5960_CDC_29	21	20	1	0	scaffold_2	2305956	2355956
Aspergillus_fumigatus_B5960_CDC_29	17	15	2	0	scaffold_6	1289473	1339473
Aspergillus_fumigatus_B5960_CDC_29	19	16	3	0	scaffold_3	707339	757339
Aspergillus_fumigatus_B5960_CDC_29	19	18	1	0	scaffold_3	2941399	2991399
Aspergillus_fumigatus_B5960_CDC_29	24	20	4	0	scaffold_8	1169970	1219970
Aspergillus_fumigatus_B5960_CDC_29	18	17	1	0	scaffold_5	1529237	1579237
Aspergillus_fumigatus_B5960_CDC_29	19	15	4	0	scaffold_2	3698112	3748112
Aspergillus_fumigatus_B5960_CDC_29	18	18	0	0	scaffold_5	3107444	3157444
Aspergillus_fumigatus_B5960_CDC_29	16	16	0	0	scaffold_3	1666011	1716011
Aspergillus_fumigatus_B5960_CDC_29	17	17	0	0	scaffold_2	2782633	2832633
Aspergillus_fumigatus_B5960_CDC_29	3	3	0	0	scaffold_7	881639	931639
Aspergillus_fumigatus_B5960_CDC_29	21	19	2	0	scaffold_4	720052	770052
Aspergillus_fumigatus_B5960_CDC_29	10	9	1	0	scaffold_4	2346521	2396521
Aspergillus_fumigatus_B5960_CDC_29	17	15	2	0	scaffold_4	1922368	1972368
Aspergillus_fumigatus_B5960_CDC_29	16	15	1	0	scaffold_7	605293	655293
Aspergillus_fumigatus_B5960_CDC_29	16	15	1	0	scaffold_1	790141	840141
Aspergillus_fumigatus_B5960_CDC_29	15	14	1	0	scaffold_6	3309048	3359048
Aspergillus_fumigatus_B5960_CDC_29	20	20	0	0	scaffold_4	2610191	2660191
Aspergillus_fumigatus_B5960_CDC_29	20	20	0	0	scaffold_5	333353	383353
Aspergillus_fumigatus_B5960_CDC_29	15	14	1	0	scaffold_2	4648111	4698111
Aspergillus_fumigatus_B5960_CDC_29	22	21	1	0	scaffold_2	1265339	1315339
Aspergillus_fumigatus_B5960_CDC_29	17	15	2	0	scaffold_1	4822977	4872977
Aspergillus_fumigatus_B5960_CDC_29	14	13	1	0	scaffold_5	716234	766234
Aspergillus_fumigatus_B5960_CDC_29	18	17	1	0	scaffold_1	2592374	2642374
Aspergillus_fumigatus_B5960_CDC_29	19	14	5	0	scaffold_1	1395326	1445326
Aspergillus_fumigatus_B5960_CDC_29	19	16	3	0	scaffold_7	421743	471743
Aspergillus_fumigatus_B5960_CDC_29	7	5	2	0	scaffold_3	1929319	1979319
Aspergillus_fumigatus_B5960_CDC_29	16	14	2	0	scaffold_4	2529927	2579927
Aspergillus_fumigatus_B5960_CDC_29	22	20	2	0	scaffold_6	2578624	2628624
Aspergillus_fumigatus_B5960_CDC_29	24	21	3	0	scaffold_5	453386	503386
Aspergillus_fumigatus_B5960_CDC_29	20	18	2	0	scaffold_3	2594641	2644641
Aspergillus_fumigatus_B5960_CDC_29	18	17	1	0	scaffold_2	3868519	3918519
Aspergillus_fumigatus_B5960_CDC_29	19	15	4	0	scaffold_6	2408304	2458304
Aspergillus_fumigatus_B5960_CDC_29	18	16	2	0	scaffold_2	2828826	2878826
Aspergillus_fumigatus_B5960_CDC_29	19	17	2	0	scaffold_4	2718740	2768740
Aspergillus_fumigatus_B5960_CDC_29	15	13	2	0	scaffold_5	3219950	3269950
Aspergillus_fumigatus_B5960_CDC_29	8	5	3	0	scaffold_8	742485	792485
Aspergillus_fumigatus_B5960_CDC_29	13	12	1	0	scaffold_6	1428540	1478540
Aspergillus_fumigatus_B5960_CDC_29	18	17	1	0	scaffold_1	1327622	1377622
Aspergillus_fumigatus_B5960_CDC_29	24	20	4	0	scaffold_7	53170	103170
Aspergillus_fumigatus_B5960_CDC_29	21	19	2	0	scaffold_6	3189135	3239135
Aspergillus_fumigatus_B5960_CDC_29	23	19	4	0	scaffold_6	505922	555922
Aspergillus_fumigatus_B5960_CDC_29	16	15	1	0	scaffold_2	4523829	4573829
Aspergillus_fumigatus_B5960_CDC_29	22	18	4	0	scaffold_7	378909	428909
Aspergillus_fumigatus_B5960_CDC_29	2	1	1	0	scaffold_8	728119	778119
Aspergillus_fumigatus_B5960_CDC_29	15	12	3	0	scaffold_5	2191365	2241365
Aspergillus_fumigatus_B5960_CDC_29	19	16	3	0	scaffold_1	3478015	3528015
Aspergillus_fumigatus_B5960_CDC_29	17	15	2	0	scaffold_1	1466719	1516719
Aspergillus_fumigatus_B5960_CDC_29	16	13	3	0	scaffold_4	3869899	3919899
Aspergillus_fumigatus_B5960_CDC_29	18	17	1	0	scaffold_7	1090412	1140412
Aspergillus_fumigatus_B5960_CDC_29	17	15	2	0	scaffold_3	3190073	3240073
Aspergillus_fumigatus_B5960_CDC_29	20	18	2	0	scaffold_4	3727679	3777679
Aspergillus_fumigatus_B5960_CDC_29	22	22	0	0	scaffold_4	456980	506980
Aspergillus_fumigatus_B5960_CDC_29	21	19	2	0	scaffold_4	1215787	1265787
Aspergillus_fumigatus_B5960_CDC_29	7	5	2	0	scaffold_3	1928992	1978992
Aspergillus_fumigatus_B5960_CDC_29	18	17	1	0	scaffold_5	377313	427313
Aspergillus_fumigatus_B5960_CDC_29	25	24	1	0	scaffold_6	2295965	2345965
Aspergillus_fumigatus_B5960_CDC_29	18	6	12	0	scaffold_1	4523624	4573624
Aspergillus_fumigatus_B5960_CDC_29	9	9	0	0	scaffold_2	2761365	2811365
Aspergillus_fumigatus_B5960_CDC_29	20	17	3	0	scaffold_4	3606078	3656078
Aspergillus_fumigatus_B5960_CDC_29	19	17	2	0	scaffold_7	10933	60933
Aspergillus_fumigatus_B5960_CDC_29	21	20	1	0	scaffold_6	811413	861413
Aspergillus_fumigatus_B5960_CDC_29	23	19	4	0	scaffold_5	2495933	2545933
Aspergillus_fumigatus_B5960_CDC_29	16	16	0	0	scaffold_2	890964	940964
Aspergillus_fumigatus_B5960_CDC_29	22	17	5	0	scaffold_1	3973215	4023215
Aspergillus_fumigatus_B5960_CDC_29	8	7	1	0	scaffold_2	2185953	2235953
Aspergillus_fumigatus_B5960_CDC_29	17	16	1	0	scaffold_5	806317	856317
Aspergillus_fumigatus_B5960_CDC_29	20	20	0	0	scaffold_1	451037	501037
Aspergillus_fumigatus_B5960_CDC_29	20	18	2	0	scaffold_2	1880758	1930758
Aspergillus_fumigatus_B5960_CDC_29	18	18	0	0	scaffold_4	3385223	3435223
Aspergillus_fumigatus_B5960_CDC_29	21	18	3	0	scaffold_4	1323199	1373199
Aspergillus_fumigatus_B5960_CDC_29	19	16	3	0	scaffold_1	286671	336671
Aspergillus_fumigatus_B5960_CDC_29	17	16	1	0	scaffold_4	3462808	3512808
Aspergillus_fumigatus_B5960_CDC_29	20	19	1	0	scaffold_2	250362	300362
Aspergillus_fumigatus_B5960_CDC_29	20	16	4	0	scaffold_3	750085	800085
Aspergillus_fumigatus_B5960_CDC_29	18	17	1	0	scaffold_8	846852	896852
Aspergillus_fumigatus_B5960_CDC_29	12	11	1	0	scaffold_5	2990523	3040523
Aspergillus_fumigatus_B5960_CDC_29	20	17	3	0	scaffold_2	3031907	3081907
Aspergillus_fumigatus_B5960_CDC_29	19	17	2	0	scaffold_4	1791727	1841727
Aspergillus_fumigatus_B5960_CDC_29	21	20	1	0	scaffold_1	1664727	1714727
Aspergillus_fumigatus_B5960_CDC_29	20	18	2	0	scaffold_3	324876	374876
Aspergillus_fumigatus_B5960_CDC_29	11	11	0	0	scaffold_1	1927728	1977728
Aspergillus_fumigatus_B5960_CDC_29	24	20	4	0	scaffold_1	130954	180954
Aspergillus_fumigatus_B5960_CDC_29	24	21	3	0	scaffold_3	2212873	2262873
Aspergillus_fumigatus_B5960_CDC_29	19	17	2	0	scaffold_4	3239820	3289820
Aspergillus_fumigatus_B5960_CDC_29	0	0	0	0	scaffold_1	1888264	1938264
Aspergillus_fumigatus_B5960_CDC_29	15	13	2	0	scaffold_3	1599726	1649726
Aspergillus_fumigatus_B5960_CDC_29	19	19	0	0	scaffold_1	2660629	2710629
Aspergillus_fumigatus_B5960_CDC_29	18	16	2	0	scaffold_2	2834541	2884541
Aspergillus_fumigatus_B5960_CDC_29	21	18	3	0	scaffold_6	1613638	1663638
Aspergillus_fumigatus_B5960_CDC_29	16	14	2	0	scaffold_4	2053876	2103876
Aspergillus_fumigatus_B5960_CDC_29	18	18	0	0	scaffold_5	360774	410774
Aspergillus_fumigatus_B5960_CDC_29	17	15	2	0	scaffold_7	823427	873427
Aspergillus_fumigatus_B5960_CDC_29	15	15	0	0	scaffold_1	2790148	2840148
Aspergillus_fumigatus_B5960_CDC_29	17	16	1	0	scaffold_3	2780598	2830598
Aspergillus_fumigatus_B5960_CDC_29	17	15	2	0	scaffold_4	1805316	1855316
Aspergillus_fumigatus_B5960_CDC_29	24	20	4	0	scaffold_8	1169865	1219865
Aspergillus_fumigatus_B5960_CDC_29	18	18	0	0	scaffold_4	3380811	3430811
Aspergillus_fumigatus_B5960_CDC_29	22	22	0	0	scaffold_6	1833422	1883422
Aspergillus_fumigatus_B5960_CDC_29	18	17	1	0	scaffold_6	1331815	1381815
Aspergillus_fumigatus_B5960_CDC_29	20	19	1	0	scaffold_2	250276	300276
Aspergillus_fumigatus_B5960_CDC_29	22	21	1	0	scaffold_1	2173898	2223898
Aspergillus_fumigatus_B5960_CDC_29	22	21	1	0	scaffold_1	1644366	1694366
Aspergillus_fumigatus_B5960_CDC_29	17	14	3	0	scaffold_2	1431680	1481680
Aspergillus_fumigatus_B5960_CDC_29	19	19	0	0	scaffold_5	292524	342524
Aspergillus_fumigatus_B5960_CDC_29	21	20	1	0	scaffold_5	3173401	3223401
Aspergillus_fumigatus_B5960_CDC_29	18	15	3	0	scaffold_7	384999	434999
Aspergillus_fumigatus_B5960_CDC_29	10	10	0	0	scaffold_4	2378174	2428174
Aspergillus_fumigatus_B5960_CDC_29	14	10	4	0	scaffold_4	170882	220882
Aspergillus_fumigatus_B5960_CDC_29	19	19	0	0	scaffold_4	987259	1037259
Aspergillus_fumigatus_B5960_CDC_29	22	20	2	0	scaffold_7	1282199	1332199
Aspergillus_fumigatus_B5960_CDC_29	20	17	3	0	scaffold_2	1019764	1069764
Aspergillus_fumigatus_B5960_CDC_29	15	15	0	0	scaffold_6	2750675	2800675
Aspergillus_fumigatus_B5960_CDC_29	14	12	2	0	scaffold_3	69207	119207
Aspergillus_fumigatus_B5960_CDC_29	16	16	0	0	scaffold_3	1671291	1721291
Aspergillus_fumigatus_B5960_CDC_29	22	20	2	0	scaffold_6	1699530	1749530
Aspergillus_fumigatus_B5960_CDC_29	25	23	2	0	scaffold_2	2533539	2583539
Aspergillus_fumigatus_B5960_CDC_29	21	18	3	0	scaffold_2	242341	292341
Aspergillus_fumigatus_B5960_CDC_29	20	20	0	0	scaffold_4	320065	370065
Aspergillus_fumigatus_B5960_CDC_29	17	16	1	0	scaffold_5	2130464	2180464
Aspergillus_fumigatus_B5960_CDC_29	18	17	1	0	scaffold_7	946188	996188
Aspergillus_fumigatus_B5960_CDC_29	18	18	0	0	scaffold_1	2256885	2306885
Aspergillus_fumigatus_B5960_CDC_29	19	17	2	0	scaffold_1	830517	880517
Aspergillus_fumigatus_B5960_CDC_29	12	11	1	0	scaffold_6	367816	417816
Aspergillus_fumigatus_B5960_CDC_29	23	19	4	0	scaffold_3	26610	76610
Aspergillus_fumigatus_B5960_CDC_29	13	13	0	0	scaffold_8	627851	677851
Aspergillus_fumigatus_B5960_CDC_29	3	2	1	0	scaffold_8	729399	779399
Aspergillus_fumigatus_B5960_CDC_29	22	19	3	0	scaffold_2	1321336	1371336
Aspergillus_fumigatus_B5960_CDC_29	21	18	3	0	scaffold_3	1772397	1822397
Aspergillus_fumigatus_B5960_CDC_29	24	24	0	0	scaffold_6	2550318	2600318
Aspergillus_fumigatus_B5960_CDC_29	12	12	0	0	scaffold_4	1665679	1715679
Aspergillus_fumigatus_B5960_CDC_29	23	23	0	0	scaffold_5	976269	1026269
Aspergillus_fumigatus_B5960_CDC_29	23	21	2	0	scaffold_4	603470	653470
Aspergillus_fumigatus_B5960_CDC_29	16	16	0	0	scaffold_2	881171	931171
Aspergillus_fumigatus_B5960_CDC_29	18	16	1	1	scaffold_3	3317199	3367199
Aspergillus_fumigatus_B5960_CDC_29	24	19	5	0	scaffold_8	1165531	1215531
Aspergillus_fumigatus_B5960_CDC_29	19	17	2	0	scaffold_6	860837	910837
Aspergillus_fumigatus_B5960_CDC_29	29	23	6	0	scaffold_5	3709165	3759165
Aspergillus_fumigatus_B5960_CDC_29	18	15	3	0	scaffold_3	308254	358254
Aspergillus_fumigatus_B5960_CDC_29	22	19	3	0	scaffold_1	3910292	3960292
Aspergillus_fumigatus_B5960_CDC_29	23	21	2	0	scaffold_3	1577361	1627361
Aspergillus_fumigatus_B5960_CDC_29	19	18	1	0	scaffold_6	2530336	2580336
Aspergillus_fumigatus_B5960_CDC_29	17	15	2	0	scaffold_6	526515	576515
Aspergillus_fumigatus_B5960_CDC_29	15	15	0	0	scaffold_1	1140563	1190563
Aspergillus_fumigatus_B5960_CDC_29	15	14	1	0	scaffold_5	1465315	1515315
Aspergillus_fumigatus_B5960_CDC_29	24	21	3	0	scaffold_7	1464318	1514318
Aspergillus_fumigatus_B5960_CDC_29	21	20	1	0	scaffold_4	764549	814549
Aspergillus_fumigatus_B5960_CDC_29	19	15	4	0	scaffold_5	2462892	2512892
Aspergillus_fumigatus_B5960_CDC_29	15	14	1	0	scaffold_4	2521215	2571215
Aspergillus_fumigatus_B5960_CDC_29	20	17	3	0	scaffold_2	3026450	3076450
Aspergillus_fumigatus_B5960_CDC_29	18	17	1	0	scaffold_6	1329015	1379015
Aspergillus_fumigatus_B5960_CDC_29	19	18	1	0	scaffold_3	3035061	3085061
Aspergillus_fumigatus_B5960_CDC_29	20	20	0	0	scaffold_4	3394253	3444253
Aspergillus_fumigatus_B5960_CDC_29	18	15	3	0	scaffold_6	620287	670287
Aspergillus_fumigatus_B5960_CDC_29	15	15	0	0	scaffold_1	1624202	1674202
Aspergillus_fumigatus_B5960_CDC_29	10	9	1	0	scaffold_2	2192677	2242677
Aspergillus_fumigatus_B5960_CDC_29	17	14	3	0	scaffold_6	582241	632241
Aspergillus_fumigatus_B5960_CDC_29	17	16	1	0	scaffold_1	1943406	1993406
Aspergillus_fumigatus_B5960_CDC_29	17	16	1	0	scaffold_3	3070571	3120571
Aspergillus_fumigatus_B5960_CDC_29	22	20	2	0	scaffold_1	1221822	1271822
Aspergillus_fumigatus_B5960_CDC_29	20	18	2	0	scaffold_8	855532	905532
Aspergillus_fumigatus_B5960_CDC_29	18	17	1	0	scaffold_7	1020703	1070703
Aspergillus_fumigatus_B5960_CDC_29	17	16	1	0	scaffold_3	3638604	3688604
Aspergillus_fumigatus_B5960_CDC_29	25	21	4	0	scaffold_2	2643007	2693007
Aspergillus_fumigatus_B5960_CDC_29	21	18	3	0	scaffold_7	516595	566595
Aspergillus_fumigatus_B5960_CDC_29	19	18	1	0	scaffold_4	288191	338191
Aspergillus_fumigatus_B5960_CDC_29	21	19	2	0	scaffold_4	487199	537199
Aspergillus_fumigatus_B5960_CDC_29	19	16	3	0	scaffold_5	3445202	3495202
Aspergillus_fumigatus_B5960_CDC_29	10	8	2	0	scaffold_1	2107154	2157154
Aspergillus_fumigatus_B5960_CDC_29	19	18	1	0	scaffold_5	765150	815150
Aspergillus_fumigatus_B5960_CDC_29	17	15	2	0	scaffold_2	3073466	3123466
Aspergillus_fumigatus_B5960_CDC_29	18	16	2	0	scaffold_7	1677566	1727566
Aspergillus_fumigatus_B5960_CDC_29	20	18	2	0	scaffold_3	324328	374328
Aspergillus_fumigatus_B5960_CDC_29	15	10	5	0	scaffold_1	3545652	3595652
Aspergillus_fumigatus_B5960_CDC_29	21	20	1	0	scaffold_6	1892971	1942971
Aspergillus_fumigatus_B5960_CDC_29	22	22	0	0	scaffold_4	3704711	3754711
Aspergillus_fumigatus_B5960_CDC_29	17	16	1	0	scaffold_4	1291702	1341702
Aspergillus_fumigatus_B5960_CDC_29	18	17	1	0	scaffold_4	3435984	3485984
Aspergillus_fumigatus_B5960_CDC_29	26	20	6	0	scaffold_6	3679312	3729312
Aspergillus_fumigatus_B5960_CDC_29	15	13	2	0	scaffold_1	1009590	1059590
Aspergillus_fumigatus_B5960_CDC_29	16	14	2	0	scaffold_2	2105922	2155922
Aspergillus_fumigatus_B5960_CDC_29	24	23	1	0	scaffold_5	3492510	3542510
Aspergillus_fumigatus_B5960_CDC_29	28	24	4	0	scaffold_2	223485	273485
Aspergillus_fumigatus_B5960_CDC_29	16	15	1	0	scaffold_8	1008453	1058453
Aspergillus_fumigatus_B5960_CDC_29	15	14	1	0	scaffold_1	3741727	3791727
