STRAIN	TOTAL	CORE	ACCESSORY	SINGLETON	CHROM	START	END
Aspergillus_fumigatus_DMC2_AF100-1_4	30	28	2	0	scaffold_4	1479008	1579008
Aspergillus_fumigatus_DMC2_AF100-1_4	37	36	1	0	scaffold_6	1299794	1399794
Aspergillus_fumigatus_DMC2_AF100-1_4	21	19	2	0	scaffold_1	1832273	1932273
Aspergillus_fumigatus_DMC2_AF100-1_4	44	31	13	0	scaffold_6	288576	388576
Aspergillus_fumigatus_DMC2_AF100-1_4	36	23	13	0	scaffold_6	420890	520890
Aspergillus_fumigatus_DMC2_AF100-1_4	20	18	2	0	scaffold_5	1133030	1233030
Aspergillus_fumigatus_DMC2_AF100-1_4	43	38	5	0	scaffold_3	1652321	1752321
Aspergillus_fumigatus_DMC2_AF100-1_4	38	37	1	0	scaffold_4	2309322	2409322
Aspergillus_fumigatus_DMC2_AF100-1_4	38	34	4	0	scaffold_2	1426686	1526686
Aspergillus_fumigatus_DMC2_AF100-1_4	13	12	1	0	scaffold_1	1871188	1971188
Aspergillus_fumigatus_DMC2_AF100-1_4	13	7	6	0	scaffold_4	12481	112481
Aspergillus_fumigatus_DMC2_AF100-1_4	36	36	0	0	scaffold_6	1266901	1366901
Aspergillus_fumigatus_DMC2_AF100-1_4	40	34	6	0	scaffold_1	4021787	4121787
Aspergillus_fumigatus_DMC2_AF100-1_4	49	40	9	0	scaffold_5	38605	138605
Aspergillus_fumigatus_DMC2_AF100-1_4	48	41	7	0	scaffold_7	275112	375112
Aspergillus_fumigatus_DMC2_AF100-1_4	38	36	2	0	scaffold_2	3000946	3100946
Aspergillus_fumigatus_DMC2_AF100-1_4	46	36	10	0	scaffold_4	176824	276824
Aspergillus_fumigatus_DMC2_AF100-1_4	31	26	5	0	scaffold_1	3001505	3101505
Aspergillus_fumigatus_DMC2_AF100-1_4	36	33	3	0	scaffold_6	832962	932962
Aspergillus_fumigatus_DMC2_AF100-1_4	36	33	3	0	scaffold_4	1773645	1873645
Aspergillus_fumigatus_DMC2_AF100-1_4	38	36	2	0	scaffold_2	670976	770976
Aspergillus_fumigatus_DMC2_AF100-1_4	36	32	4	0	scaffold_5	1769445	1869445
Aspergillus_fumigatus_DMC2_AF100-1_4	39	36	3	0	scaffold_6	772263	872263
Aspergillus_fumigatus_DMC2_AF100-1_4	44	39	5	0	scaffold_6	3260646	3360646
Aspergillus_fumigatus_DMC2_AF100-1_4	34	31	3	0	scaffold_5	3220365	3320365
Aspergillus_fumigatus_DMC2_AF100-1_4	38	36	2	0	scaffold_3	1954436	2054436
Aspergillus_fumigatus_DMC2_AF100-1_4	23	18	5	0	scaffold_1	2118626	2218626
Aspergillus_fumigatus_DMC2_AF100-1_4	29	26	3	0	scaffold_3	3080489	3180489
Aspergillus_fumigatus_DMC2_AF100-1_4	14	9	5	0	scaffold_5	2087715	2187715
Aspergillus_fumigatus_DMC2_AF100-1_4	33	27	6	0	scaffold_3	3420127	3520127
Aspergillus_fumigatus_DMC2_AF100-1_4	45	43	2	0	scaffold_3	4028003	4128003
Aspergillus_fumigatus_DMC2_AF100-1_4	35	34	1	0	scaffold_6	1641878	1741878
Aspergillus_fumigatus_DMC2_AF100-1_4	40	30	10	0	scaffold_5	2778206	2878206
Aspergillus_fumigatus_DMC2_AF100-1_4	35	33	2	0	scaffold_1	3784135	3884135
Aspergillus_fumigatus_DMC2_AF100-1_4	41	36	5	0	scaffold_3	3649869	3749869
Aspergillus_fumigatus_DMC2_AF100-1_4	33	31	2	0	scaffold_3	2886232	2986232
Aspergillus_fumigatus_DMC2_AF100-1_4	39	39	0	0	scaffold_2	1685362	1785362
Aspergillus_fumigatus_DMC2_AF100-1_4	41	37	4	0	scaffold_8	65639	165639
Aspergillus_fumigatus_DMC2_AF100-1_4	34	32	2	0	scaffold_1	3113295	3213295
Aspergillus_fumigatus_DMC2_AF100-1_4	39	38	1	0	scaffold_4	351574	451574
Aspergillus_fumigatus_DMC2_AF100-1_4	41	38	3	0	scaffold_1	396267	496267
Aspergillus_fumigatus_DMC2_AF100-1_4	39	37	2	0	scaffold_4	2801261	2901261
Aspergillus_fumigatus_DMC2_AF100-1_4	31	29	2	0	scaffold_1	1543764	1643764
Aspergillus_fumigatus_DMC2_AF100-1_4	43	42	1	0	scaffold_5	1928269	2028269
Aspergillus_fumigatus_DMC2_AF100-1_4	24	21	3	0	scaffold_5	1080741	1180741
Aspergillus_fumigatus_DMC2_AF100-1_4	47	41	6	0	scaffold_4	3760515	3860515
Aspergillus_fumigatus_DMC2_AF100-1_4	43	39	4	0	scaffold_5	1426514	1526514
Aspergillus_fumigatus_DMC2_AF100-1_4	40	37	3	0	scaffold_5	1232505	1332505
Aspergillus_fumigatus_DMC2_AF100-1_4	33	27	6	0	scaffold_1	4111433	4211433
Aspergillus_fumigatus_DMC2_AF100-1_4	44	41	3	0	scaffold_2	2182090	2282090
Aspergillus_fumigatus_DMC2_AF100-1_4	45	44	1	0	scaffold_6	2214038	2314038
Aspergillus_fumigatus_DMC2_AF100-1_4	37	25	12	0	scaffold_3	7636	107636
Aspergillus_fumigatus_DMC2_AF100-1_4	33	33	0	0	scaffold_5	3129994	3229994
Aspergillus_fumigatus_DMC2_AF100-1_4	35	32	3	0	scaffold_6	6974	106974
Aspergillus_fumigatus_DMC2_AF100-1_4	30	28	2	0	scaffold_1	2021923	2121923
Aspergillus_fumigatus_DMC2_AF100-1_4	35	32	3	0	scaffold_3	2653246	2753246
Aspergillus_fumigatus_DMC2_AF100-1_4	29	25	4	0	scaffold_6	498500	598500
Aspergillus_fumigatus_DMC2_AF100-1_4	31	30	1	0	scaffold_1	1558217	1658217
Aspergillus_fumigatus_DMC2_AF100-1_4	36	35	1	0	scaffold_8	1231823	1331823
Aspergillus_fumigatus_DMC2_AF100-1_4	38	37	1	0	scaffold_6	1575862	1675862
Aspergillus_fumigatus_DMC2_AF100-1_4	35	33	2	0	scaffold_8	1559043	1659043
Aspergillus_fumigatus_DMC2_AF100-1_4	30	25	5	0	scaffold_6	512515	612515
Aspergillus_fumigatus_DMC2_AF100-1_4	34	30	4	0	scaffold_2	3143380	3243380
Aspergillus_fumigatus_DMC2_AF100-1_4	33	33	0	0	scaffold_6	2938623	3038623
Aspergillus_fumigatus_DMC2_AF100-1_4	38	34	4	0	scaffold_1	3208104	3308104
Aspergillus_fumigatus_DMC2_AF100-1_4	43	37	6	0	scaffold_3	3680197	3780197
Aspergillus_fumigatus_DMC2_AF100-1_4	31	27	4	0	scaffold_1	3515103	3615103
Aspergillus_fumigatus_DMC2_AF100-1_4	31	26	5	0	scaffold_5	105847	205847
Aspergillus_fumigatus_DMC2_AF100-1_4	37	32	5	0	scaffold_2	1872322	1972322
Aspergillus_fumigatus_DMC2_AF100-1_4	38	37	1	0	scaffold_8	1216577	1316577
Aspergillus_fumigatus_DMC2_AF100-1_4	36	31	5	0	scaffold_2	579544	679544
Aspergillus_fumigatus_DMC2_AF100-1_4	37	34	3	0	scaffold_1	1040405	1140405
Aspergillus_fumigatus_DMC2_AF100-1_4	39	34	5	0	scaffold_7	62813	162813
Aspergillus_fumigatus_DMC2_AF100-1_4	36	36	0	0	scaffold_1	612666	712666
Aspergillus_fumigatus_DMC2_AF100-1_4	40	39	1	0	scaffold_6	960474	1060474
Aspergillus_fumigatus_DMC2_AF100-1_4	43	36	7	0	scaffold_3	1021450	1121450
Aspergillus_fumigatus_DMC2_AF100-1_4	36	34	2	0	scaffold_6	1524218	1624218
Aspergillus_fumigatus_DMC2_AF100-1_4	38	37	1	0	scaffold_6	2770268	2870268
Aspergillus_fumigatus_DMC2_AF100-1_4	40	34	6	0	scaffold_4	1662137	1762137
Aspergillus_fumigatus_DMC2_AF100-1_4	37	37	0	0	scaffold_4	3154279	3254279
Aspergillus_fumigatus_DMC2_AF100-1_4	36	31	5	0	scaffold_2	1046224	1146224
Aspergillus_fumigatus_DMC2_AF100-1_4	50	41	9	0	scaffold_4	3620426	3720426
Aspergillus_fumigatus_DMC2_AF100-1_4	31	30	1	0	scaffold_7	569666	669666
Aspergillus_fumigatus_DMC2_AF100-1_4	39	36	3	0	scaffold_5	1871958	1971958
Aspergillus_fumigatus_DMC2_AF100-1_4	37	35	2	0	scaffold_4	2269154	2369154
Aspergillus_fumigatus_DMC2_AF100-1_4	34	33	1	0	scaffold_5	2970909	3070909
Aspergillus_fumigatus_DMC2_AF100-1_4	43	39	4	0	scaffold_3	2386584	2486584
Aspergillus_fumigatus_DMC2_AF100-1_4	40	39	1	0	scaffold_8	647674	747674
Aspergillus_fumigatus_DMC2_AF100-1_4	21	17	4	0	scaffold_1	2143275	2243275
Aspergillus_fumigatus_DMC2_AF100-1_4	39	36	3	0	scaffold_4	2890270	2990270
Aspergillus_fumigatus_DMC2_AF100-1_4	30	28	2	0	scaffold_6	1393272	1493272
Aspergillus_fumigatus_DMC2_AF100-1_4	20	15	5	0	scaffold_5	2063497	2163497
Aspergillus_fumigatus_DMC2_AF100-1_4	38	37	1	0	scaffold_6	1288517	1388517
Aspergillus_fumigatus_DMC2_AF100-1_4	49	37	12	0	scaffold_5	18223	118223
Aspergillus_fumigatus_DMC2_AF100-1_4	40	37	3	0	scaffold_6	2254568	2354568
Aspergillus_fumigatus_DMC2_AF100-1_4	39	37	2	0	scaffold_2	1111696	1211696
Aspergillus_fumigatus_DMC2_AF100-1_4	44	42	2	0	scaffold_6	2219776	2319776
Aspergillus_fumigatus_DMC2_AF100-1_4	45	35	10	0	scaffold_1	4241598	4341598
Aspergillus_fumigatus_DMC2_AF100-1_4	37	27	10	0	scaffold_2	2725931	2825931
Aspergillus_fumigatus_DMC2_AF100-1_4	40	34	6	0	scaffold_1	266798	366798
Aspergillus_fumigatus_DMC2_AF100-1_4	42	38	4	0	scaffold_1	3909696	4009696
Aspergillus_fumigatus_DMC2_AF100-1_4	39	36	3	0	scaffold_3	3620552	3720552
Aspergillus_fumigatus_DMC2_AF100-1_4	41	36	5	0	scaffold_2	1916225	2016225
Aspergillus_fumigatus_DMC2_AF100-1_4	37	33	4	0	scaffold_3	2215392	2315392
Aspergillus_fumigatus_DMC2_AF100-1_4	37	35	2	0	scaffold_1	2208046	2308046
Aspergillus_fumigatus_DMC2_AF100-1_4	12	10	2	0	scaffold_3	1275928	1375928
Aspergillus_fumigatus_DMC2_AF100-1_4	27	25	2	0	scaffold_1	1787877	1887877
Aspergillus_fumigatus_DMC2_AF100-1_4	40	37	3	0	scaffold_5	2352150	2452150
Aspergillus_fumigatus_DMC2_AF100-1_4	46	39	7	0	scaffold_3	3688566	3788566
Aspergillus_fumigatus_DMC2_AF100-1_4	42	37	5	0	scaffold_8	43791	143791
Aspergillus_fumigatus_DMC2_AF100-1_4	41	34	7	0	scaffold_3	1045360	1145360
Aspergillus_fumigatus_DMC2_AF100-1_4	37	35	2	0	scaffold_4	2052783	2152783
Aspergillus_fumigatus_DMC2_AF100-1_4	35	32	3	0	scaffold_3	2755191	2855191
Aspergillus_fumigatus_DMC2_AF100-1_4	34	29	5	0	scaffold_7	1339078	1439078
Aspergillus_fumigatus_DMC2_AF100-1_4	39	39	0	0	scaffold_6	2874618	2974618
Aspergillus_fumigatus_DMC2_AF100-1_4	36	33	3	0	scaffold_7	1010951	1110951
Aspergillus_fumigatus_DMC2_AF100-1_4	39	34	5	0	scaffold_4	2456920	2556920
Aspergillus_fumigatus_DMC2_AF100-1_4	48	43	5	0	scaffold_1	4957174	5057174
Aspergillus_fumigatus_DMC2_AF100-1_4	38	31	7	0	scaffold_6	3479300	3579300
Aspergillus_fumigatus_DMC2_AF100-1_4	34	32	2	0	scaffold_1	954267	1054267
Aspergillus_fumigatus_DMC2_AF100-1_4	20	19	1	0	scaffold_7	828871	928871
Aspergillus_fumigatus_DMC2_AF100-1_4	33	33	0	0	scaffold_4	620581	720581
Aspergillus_fumigatus_DMC2_AF100-1_4	34	30	4	0	scaffold_1	3653204	3753204
Aspergillus_fumigatus_DMC2_AF100-1_4	40	37	3	0	scaffold_3	2852181	2952181
Aspergillus_fumigatus_DMC2_AF100-1_4	41	37	4	0	scaffold_5	726465	826465
Aspergillus_fumigatus_DMC2_AF100-1_4	47	35	12	0	scaffold_1	4304493	4404493
Aspergillus_fumigatus_DMC2_AF100-1_4	27	24	3	0	scaffold_7	779632	879632
Aspergillus_fumigatus_DMC2_AF100-1_4	28	20	8	0	scaffold_5	228929	328929
Aspergillus_fumigatus_DMC2_AF100-1_4	38	37	1	0	scaffold_8	644303	744303
Aspergillus_fumigatus_DMC2_AF100-1_4	38	37	1	0	scaffold_2	1810469	1910469
Aspergillus_fumigatus_DMC2_AF100-1_4	41	38	3	0	scaffold_1	345837	445837
Aspergillus_fumigatus_DMC2_AF100-1_4	38	33	5	0	scaffold_1	3939758	4039758
Aspergillus_fumigatus_DMC2_AF100-1_4	36	30	6	0	scaffold_1	4163732	4263732
Aspergillus_fumigatus_DMC2_AF100-1_4	41	35	6	0	scaffold_1	3370937	3470937
Aspergillus_fumigatus_DMC2_AF100-1_4	45	37	8	0	scaffold_6	236505	336505
Aspergillus_fumigatus_DMC2_AF100-1_4	43	40	3	0	scaffold_6	2189795	2289795
Aspergillus_fumigatus_DMC2_AF100-1_4	34	34	0	0	scaffold_5	3128701	3228701
Aspergillus_fumigatus_DMC2_AF100-1_4	38	33	5	0	scaffold_4	1855054	1955054
Aspergillus_fumigatus_DMC2_AF100-1_4	40	37	3	0	scaffold_2	2273472	2373472
Aspergillus_fumigatus_DMC2_AF100-1_4	34	30	4	0	scaffold_1	1094742	1194742
Aspergillus_fumigatus_DMC2_AF100-1_4	38	38	0	0	scaffold_2	3543679	3643679
Aspergillus_fumigatus_DMC2_AF100-1_4	34	32	2	0	scaffold_2	1493754	1593754
Aspergillus_fumigatus_DMC2_AF100-1_4	42	37	5	0	scaffold_8	61356	161356
Aspergillus_fumigatus_DMC2_AF100-1_4	32	31	1	0	scaffold_4	1499715	1599715
Aspergillus_fumigatus_DMC2_AF100-1_4	36	35	1	0	scaffold_6	2972951	3072951
Aspergillus_fumigatus_DMC2_AF100-1_4	41	38	3	0	scaffold_5	2358279	2458279
Aspergillus_fumigatus_DMC2_AF100-1_4	37	37	0	0	scaffold_4	3186326	3286326
Aspergillus_fumigatus_DMC2_AF100-1_4	48	43	5	0	scaffold_1	154426	254426
Aspergillus_fumigatus_DMC2_AF100-1_4	38	36	2	0	scaffold_3	3171474	3271474
Aspergillus_fumigatus_DMC2_AF100-1_4	30	24	6	0	scaffold_4	3251680	3351680
Aspergillus_fumigatus_DMC2_AF100-1_4	43	39	4	0	scaffold_8	155230	255230
Aspergillus_fumigatus_DMC2_AF100-1_4	8	4	4	0	scaffold_5	2134144	2234144
Aspergillus_fumigatus_DMC2_AF100-1_4	36	32	4	0	scaffold_3	845365	945365
Aspergillus_fumigatus_DMC2_AF100-1_4	31	30	1	0	scaffold_4	1497708	1597708
Aspergillus_fumigatus_DMC2_AF100-1_4	46	43	3	0	scaffold_3	1608941	1708941
Aspergillus_fumigatus_DMC2_AF100-1_4	31	30	1	0	scaffold_7	569766	669766
Aspergillus_fumigatus_DMC2_AF100-1_4	35	33	2	0	scaffold_4	2084809	2184809
Aspergillus_fumigatus_DMC2_AF100-1_4	36	33	3	0	scaffold_5	376914	476914
Aspergillus_fumigatus_DMC2_AF100-1_4	40	33	7	0	scaffold_3	596056	696056
Aspergillus_fumigatus_DMC2_AF100-1_4	40	34	6	0	scaffold_1	269897	369897
Aspergillus_fumigatus_DMC2_AF100-1_4	32	29	3	0	scaffold_2	1241574	1341574
Aspergillus_fumigatus_DMC2_AF100-1_4	30	29	1	0	scaffold_2	985899	1085899
Aspergillus_fumigatus_DMC2_AF100-1_4	27	25	2	0	scaffold_2	2498307	2598307
Aspergillus_fumigatus_DMC2_AF100-1_4	33	17	16	0	scaffold_3	145265	245265
Aspergillus_fumigatus_DMC2_AF100-1_4	25	12	13	0	scaffold_6	602139	702139
Aspergillus_fumigatus_DMC2_AF100-1_4	33	32	1	0	scaffold_1	3190271	3290271
Aspergillus_fumigatus_DMC2_AF100-1_4	36	26	10	0	scaffold_2	2729283	2829283
Aspergillus_fumigatus_DMC2_AF100-1_4	12	11	1	0	scaffold_2	2044129	2144129
Aspergillus_fumigatus_DMC2_AF100-1_4	43	38	5	0	scaffold_1	2922103	3022103
Aspergillus_fumigatus_DMC2_AF100-1_4	12	10	2	0	scaffold_4	3031738	3131738
Aspergillus_fumigatus_DMC2_AF100-1_4	42	42	0	0	scaffold_2	1721414	1821414
Aspergillus_fumigatus_DMC2_AF100-1_4	28	24	4	0	scaffold_5	241249	341249
Aspergillus_fumigatus_DMC2_AF100-1_4	40	38	2	0	scaffold_5	898488	998488
Aspergillus_fumigatus_DMC2_AF100-1_4	34	31	3	0	scaffold_1	1314434	1414434
Aspergillus_fumigatus_DMC2_AF100-1_4	33	28	5	0	scaffold_1	1759208	1859208
Aspergillus_fumigatus_DMC2_AF100-1_4	26	26	0	0	scaffold_7	637205	737205
Aspergillus_fumigatus_DMC2_AF100-1_4	35	31	4	0	scaffold_1	1298316	1398316
Aspergillus_fumigatus_DMC2_AF100-1_4	28	20	8	0	scaffold_5	232836	332836
Aspergillus_fumigatus_DMC2_AF100-1_4	37	34	3	0	scaffold_3	2114196	2214196
Aspergillus_fumigatus_DMC2_AF100-1_4	33	29	4	0	scaffold_6	108819	208819
Aspergillus_fumigatus_DMC2_AF100-1_4	32	28	4	0	scaffold_2	3778163	3878163
Aspergillus_fumigatus_DMC2_AF100-1_4	38	29	9	0	scaffold_3	3863100	3963100
Aspergillus_fumigatus_DMC2_AF100-1_4	38	36	2	0	scaffold_1	3820400	3920400
Aspergillus_fumigatus_DMC2_AF100-1_4	39	38	1	0	scaffold_3	2344549	2444549
Aspergillus_fumigatus_DMC2_AF100-1_4	40	37	3	0	scaffold_2	3548996	3648996
Aspergillus_fumigatus_DMC2_AF100-1_4	44	41	3	0	scaffold_7	1595947	1695947
Aspergillus_fumigatus_DMC2_AF100-1_4	36	35	1	0	scaffold_7	549029	649029
Aspergillus_fumigatus_DMC2_AF100-1_4	33	29	4	0	scaffold_2	1453420	1553420
Aspergillus_fumigatus_DMC2_AF100-1_4	40	38	2	0	scaffold_5	858684	958684
Aspergillus_fumigatus_DMC2_AF100-1_4	44	41	3	0	scaffold_7	1595291	1695291
Aspergillus_fumigatus_DMC2_AF100-1_4	37	33	4	0	scaffold_2	4406876	4506876
Aspergillus_fumigatus_DMC2_AF100-1_4	27	23	4	0	scaffold_5	116494	216494
Aspergillus_fumigatus_DMC2_AF100-1_4	35	31	4	0	scaffold_2	1337302	1437302
Aspergillus_fumigatus_DMC2_AF100-1_4	28	23	5	0	scaffold_8	494156	594156
Aspergillus_fumigatus_DMC2_AF100-1_4	20	16	4	0	scaffold_1	2137109	2237109
Aspergillus_fumigatus_DMC2_AF100-1_4	40	37	3	0	scaffold_8	1158955	1258955
Aspergillus_fumigatus_DMC2_AF100-1_4	29	8	21	0	scaffold_3	750954	850954
Aspergillus_fumigatus_DMC2_AF100-1_4	33	30	3	0	scaffold_5	3211640	3311640
Aspergillus_fumigatus_DMC2_AF100-1_4	50	37	13	0	scaffold_1	34657	134657
Aspergillus_fumigatus_DMC2_AF100-1_4	39	36	3	0	scaffold_5	1237662	1337662
Aspergillus_fumigatus_DMC2_AF100-1_4	39	35	4	0	scaffold_3	3222212	3322212
Aspergillus_fumigatus_DMC2_AF100-1_4	44	41	3	0	scaffold_6	2197767	2297767
Aspergillus_fumigatus_DMC2_AF100-1_4	38	33	5	0	scaffold_4	2431025	2531025
Aspergillus_fumigatus_DMC2_AF100-1_4	35	31	4	0	scaffold_3	2085459	2185459
Aspergillus_fumigatus_DMC2_AF100-1_4	38	32	6	0	scaffold_1	4880791	4980791
Aspergillus_fumigatus_DMC2_AF100-1_4	35	35	0	0	scaffold_2	851591	951591
Aspergillus_fumigatus_DMC2_AF100-1_4	26	24	2	0	scaffold_2	2486540	2586540
Aspergillus_fumigatus_DMC2_AF100-1_4	46	39	7	0	scaffold_7	1143060	1243060
Aspergillus_fumigatus_DMC2_AF100-1_4	33	31	2	0	scaffold_3	1496891	1596891
Aspergillus_fumigatus_DMC2_AF100-1_4	28	24	4	0	scaffold_5	247324	347324
Aspergillus_fumigatus_DMC2_AF100-1_4	35	32	3	0	scaffold_2	3748779	3848779
Aspergillus_fumigatus_DMC2_AF100-1_4	37	34	3	0	scaffold_8	1150361	1250361
Aspergillus_fumigatus_DMC2_AF100-1_4	41	39	2	0	scaffold_1	2223915	2323915
Aspergillus_fumigatus_DMC2_AF100-1_4	29	25	4	0	scaffold_6	2342157	2442157
Aspergillus_fumigatus_DMC2_AF100-1_4	39	32	7	0	scaffold_3	3878022	3978022
Aspergillus_fumigatus_DMC2_AF100-1_4	42	38	4	0	scaffold_1	1255908	1355908
Aspergillus_fumigatus_DMC2_AF100-1_4	36	33	3	0	scaffold_4	2356832	2456832
Aspergillus_fumigatus_DMC2_AF100-1_4	34	30	4	0	scaffold_2	4333612	4433612
Aspergillus_fumigatus_DMC2_AF100-1_4	42	38	4	0	scaffold_5	2438502	2538502
Aspergillus_fumigatus_DMC2_AF100-1_4	39	35	4	0	scaffold_8	247362	347362
Aspergillus_fumigatus_DMC2_AF100-1_4	36	31	5	0	scaffold_4	1875341	1975341
Aspergillus_fumigatus_DMC2_AF100-1_4	37	33	4	0	scaffold_5	3513321	3613321
Aspergillus_fumigatus_DMC2_AF100-1_4	36	30	6	0	scaffold_1	4162683	4262683
Aspergillus_fumigatus_DMC2_AF100-1_4	45	40	5	0	scaffold_3	1002308	1102308
Aspergillus_fumigatus_DMC2_AF100-1_4	32	30	2	0	scaffold_2	3882003	3982003
Aspergillus_fumigatus_DMC2_AF100-1_4	31	30	1	0	scaffold_5	1634980	1734980
Aspergillus_fumigatus_DMC2_AF100-1_4	39	33	6	0	scaffold_1	3236961	3336961
Aspergillus_fumigatus_DMC2_AF100-1_4	37	36	1	0	scaffold_4	2778857	2878857
Aspergillus_fumigatus_DMC2_AF100-1_4	22	12	10	0	scaffold_6	622635	722635
Aspergillus_fumigatus_DMC2_AF100-1_4	37	33	4	0	scaffold_8	297651	397651
Aspergillus_fumigatus_DMC2_AF100-1_4	28	22	6	0	scaffold_4	3245610	3345610
Aspergillus_fumigatus_DMC2_AF100-1_4	23	23	0	0	scaffold_7	645851	745851
Aspergillus_fumigatus_DMC2_AF100-1_4	41	37	4	0	scaffold_1	349958	449958
Aspergillus_fumigatus_DMC2_AF100-1_4	32	30	2	0	scaffold_4	767377	867377
Aspergillus_fumigatus_DMC2_AF100-1_4	39	36	3	0	scaffold_2	1391172	1491172
Aspergillus_fumigatus_DMC2_AF100-1_4	13	13	0	0	scaffold_1	1941948	2041948
Aspergillus_fumigatus_DMC2_AF100-1_4	36	36	0	0	scaffold_1	663892	763892
Aspergillus_fumigatus_DMC2_AF100-1_4	45	44	1	0	scaffold_4	1010187	1110187
Aspergillus_fumigatus_DMC2_AF100-1_4	39	33	6	0	scaffold_1	3081214	3181214
Aspergillus_fumigatus_DMC2_AF100-1_4	40	33	7	0	scaffold_4	3511509	3611509
Aspergillus_fumigatus_DMC2_AF100-1_4	35	34	1	0	scaffold_5	2980250	3080250
Aspergillus_fumigatus_DMC2_AF100-1_4	32	30	2	0	scaffold_2	1529318	1629318
Aspergillus_fumigatus_DMC2_AF100-1_4	39	34	5	0	scaffold_3	907023	1007023
Aspergillus_fumigatus_DMC2_AF100-1_4	10	10	0	0	scaffold_7	873761	973761
Aspergillus_fumigatus_DMC2_AF100-1_4	35	35	0	0	scaffold_1	717021	817021
Aspergillus_fumigatus_DMC2_AF100-1_4	36	31	5	0	scaffold_2	570185	670185
Aspergillus_fumigatus_DMC2_AF100-1_4	38	35	3	0	scaffold_6	779556	879556
Aspergillus_fumigatus_DMC2_AF100-1_4	30	27	3	0	scaffold_1	1169071	1269071
Aspergillus_fumigatus_DMC2_AF100-1_4	44	41	3	0	scaffold_1	5078128	5178128
Aspergillus_fumigatus_DMC2_AF100-1_4	42	38	4	0	scaffold_1	5070084	5170084
Aspergillus_fumigatus_DMC2_AF100-1_4	42	42	0	0	scaffold_3	2309890	2409890
Aspergillus_fumigatus_DMC2_AF100-1_4	36	33	3	0	scaffold_2	2814625	2914625
Aspergillus_fumigatus_DMC2_AF100-1_4	46	35	11	0	scaffold_4	171683	271683
Aspergillus_fumigatus_DMC2_AF100-1_4	30	29	1	0	scaffold_4	784663	884663
Aspergillus_fumigatus_DMC2_AF100-1_4	35	34	1	0	scaffold_1	1392131	1492131
Aspergillus_fumigatus_DMC2_AF100-1_4	42	41	1	0	scaffold_5	1941220	2041220
Aspergillus_fumigatus_DMC2_AF100-1_4	24	19	5	0	scaffold_8	503727	603727
Aspergillus_fumigatus_DMC2_AF100-1_4	15	14	1	0	scaffold_2	2027273	2127273
Aspergillus_fumigatus_DMC2_AF100-1_4	39	34	5	0	scaffold_1	4214805	4314805
Aspergillus_fumigatus_DMC2_AF100-1_4	34	32	2	0	scaffold_2	1533745	1633745
Aspergillus_fumigatus_DMC2_AF100-1_4	42	37	5	0	scaffold_4	3344154	3444154
Aspergillus_fumigatus_DMC2_AF100-1_4	51	43	8	0	scaffold_5	68315	168315
Aspergillus_fumigatus_DMC2_AF100-1_4	31	27	4	0	scaffold_1	1206345	1306345
Aspergillus_fumigatus_DMC2_AF100-1_4	40	39	1	0	scaffold_4	364215	464215
Aspergillus_fumigatus_DMC2_AF100-1_4	36	35	1	0	scaffold_3	1910754	2010754
Aspergillus_fumigatus_DMC2_AF100-1_4	35	31	4	0	scaffold_1	3948230	4048230
Aspergillus_fumigatus_DMC2_AF100-1_4	40	38	2	0	scaffold_2	4059476	4159476
Aspergillus_fumigatus_DMC2_AF100-1_4	45	44	1	0	scaffold_6	2844081	2944081
Aspergillus_fumigatus_DMC2_AF100-1_4	37	34	3	0	scaffold_1	1039502	1139502
Aspergillus_fumigatus_DMC2_AF100-1_4	28	22	6	0	scaffold_8	827676	927676
Aspergillus_fumigatus_DMC2_AF100-1_4	31	28	3	0	scaffold_4	3419924	3519924
Aspergillus_fumigatus_DMC2_AF100-1_4	31	29	2	0	scaffold_6	2034365	2134365
Aspergillus_fumigatus_DMC2_AF100-1_4	41	37	4	0	scaffold_2	2851369	2951369
Aspergillus_fumigatus_DMC2_AF100-1_4	34	31	3	0	scaffold_5	2892495	2992495
Aspergillus_fumigatus_DMC2_AF100-1_4	49	44	5	0	scaffold_2	272416	372416
Aspergillus_fumigatus_DMC2_AF100-1_4	42	42	0	0	scaffold_2	1710225	1810225
Aspergillus_fumigatus_DMC2_AF100-1_4	37	35	2	0	scaffold_1	3467530	3567530
Aspergillus_fumigatus_DMC2_AF100-1_4	38	31	7	0	scaffold_1	4346446	4446446
Aspergillus_fumigatus_DMC2_AF100-1_4	42	37	5	0	scaffold_2	2202642	2302642
Aspergillus_fumigatus_DMC2_AF100-1_4	38	34	4	0	scaffold_4	3470049	3570049
Aspergillus_fumigatus_DMC2_AF100-1_4	43	41	2	0	scaffold_5	3405155	3505155
Aspergillus_fumigatus_DMC2_AF100-1_4	43	38	5	0	scaffold_2	4389835	4489835
Aspergillus_fumigatus_DMC2_AF100-1_4	14	12	2	0	scaffold_4	1162119	1262119
Aspergillus_fumigatus_DMC2_AF100-1_4	32	31	1	0	scaffold_5	1566458	1666458
Aspergillus_fumigatus_DMC2_AF100-1_4	42	38	4	0	scaffold_1	1258210	1358210
Aspergillus_fumigatus_DMC2_AF100-1_4	31	3	28	0	scaffold_3	697700	797700
Aspergillus_fumigatus_DMC2_AF100-1_4	38	36	2	0	scaffold_2	2575101	2675101
Aspergillus_fumigatus_DMC2_AF100-1_4	42	36	6	0	scaffold_3	413544	513544
Aspergillus_fumigatus_DMC2_AF100-1_4	34	32	2	0	scaffold_6	3127880	3227880
Aspergillus_fumigatus_DMC2_AF100-1_4	38	34	4	0	scaffold_5	1015087	1115087
Aspergillus_fumigatus_DMC2_AF100-1_4	0	0	0	0	scaffold_6	1076732	1176732
Aspergillus_fumigatus_DMC2_AF100-1_4	38	38	0	0	scaffold_6	2871820	2971820
Aspergillus_fumigatus_DMC2_AF100-1_4	39	37	2	0	scaffold_6	1486798	1586798
Aspergillus_fumigatus_DMC2_AF100-1_4	15	13	2	0	scaffold_2	2018818	2118818
Aspergillus_fumigatus_DMC2_AF100-1_4	29	29	0	0	scaffold_2	960091	1060091
Aspergillus_fumigatus_DMC2_AF100-1_4	40	38	2	0	scaffold_8	1648800	1748800
Aspergillus_fumigatus_DMC2_AF100-1_4	37	33	4	0	scaffold_1	3932808	4032808
Aspergillus_fumigatus_DMC2_AF100-1_4	42	39	3	0	scaffold_8	110536	210536
Aspergillus_fumigatus_DMC2_AF100-1_4	41	39	2	0	scaffold_3	2353575	2453575
Aspergillus_fumigatus_DMC2_AF100-1_4	34	32	2	0	scaffold_6	857035	957035
Aspergillus_fumigatus_DMC2_AF100-1_4	44	41	3	0	scaffold_3	2245247	2345247
Aspergillus_fumigatus_DMC2_AF100-1_4	36	26	10	0	scaffold_1	4837266	4937266
Aspergillus_fumigatus_DMC2_AF100-1_4	38	34	4	0	scaffold_1	5012247	5112247
Aspergillus_fumigatus_DMC2_AF100-1_4	34	31	3	0	scaffold_8	913461	1013461
Aspergillus_fumigatus_DMC2_AF100-1_4	31	28	3	0	scaffold_2	1273124	1373124
Aspergillus_fumigatus_DMC2_AF100-1_4	45	38	7	0	scaffold_3	2481945	2581945
Aspergillus_fumigatus_DMC2_AF100-1_4	31	31	0	0	scaffold_2	867631	967631
Aspergillus_fumigatus_DMC2_AF100-1_4	31	30	1	0	scaffold_4	735970	835970
Aspergillus_fumigatus_DMC2_AF100-1_4	38	34	4	0	scaffold_5	2285014	2385014
Aspergillus_fumigatus_DMC2_AF100-1_4	32	29	3	0	scaffold_2	1016898	1116898
Aspergillus_fumigatus_DMC2_AF100-1_4	52	39	13	0	scaffold_1	87096	187096
Aspergillus_fumigatus_DMC2_AF100-1_4	29	28	1	0	scaffold_2	2531419	2631419
Aspergillus_fumigatus_DMC2_AF100-1_4	24	21	3	0	scaffold_7	766875	866875
Aspergillus_fumigatus_DMC2_AF100-1_4	31	30	1	0	scaffold_2	3912912	4012912
Aspergillus_fumigatus_DMC2_AF100-1_4	42	38	4	0	scaffold_5	2325664	2425664
Aspergillus_fumigatus_DMC2_AF100-1_4	36	31	5	0	scaffold_1	1287804	1387804
Aspergillus_fumigatus_DMC2_AF100-1_4	42	37	5	0	scaffold_3	3656418	3756418
Aspergillus_fumigatus_DMC2_AF100-1_4	33	29	4	0	scaffold_6	2370160	2470160
Aspergillus_fumigatus_DMC2_AF100-1_4	33	33	0	0	scaffold_2	4009393	4109393
Aspergillus_fumigatus_DMC2_AF100-1_4	45	44	1	0	scaffold_6	2847618	2947618
Aspergillus_fumigatus_DMC2_AF100-1_4	45	36	9	0	scaffold_4	3582993	3682993
Aspergillus_fumigatus_DMC2_AF100-1_4	40	37	3	0	scaffold_5	647472	747472
Aspergillus_fumigatus_DMC2_AF100-1_4	40	36	4	0	scaffold_1	3320821	3420821
Aspergillus_fumigatus_DMC2_AF100-1_4	30	28	2	0	scaffold_6	1396752	1496752
Aspergillus_fumigatus_DMC2_AF100-1_4	31	28	3	0	scaffold_2	1239774	1339774
Aspergillus_fumigatus_DMC2_AF100-1_4	47	38	9	0	scaffold_8	1352641	1452641
Aspergillus_fumigatus_DMC2_AF100-1_4	37	35	2	0	scaffold_8	1002672	1102672
Aspergillus_fumigatus_DMC2_AF100-1_4	40	31	9	0	scaffold_6	2152209	2252209
Aspergillus_fumigatus_DMC2_AF100-1_4	33	32	1	0	scaffold_8	1241815	1341815
Aspergillus_fumigatus_DMC2_AF100-1_4	21	20	1	0	scaffold_7	964138	1064138
Aspergillus_fumigatus_DMC2_AF100-1_4	46	36	10	0	scaffold_1	4257319	4357319
Aspergillus_fumigatus_DMC2_AF100-1_4	28	26	2	0	scaffold_3	3477613	3577613
Aspergillus_fumigatus_DMC2_AF100-1_4	48	46	2	0	scaffold_3	4023167	4123167
Aspergillus_fumigatus_DMC2_AF100-1_4	39	39	0	0	scaffold_4	1048610	1148610
Aspergillus_fumigatus_DMC2_AF100-1_4	33	30	3	0	scaffold_2	3797723	3897723
Aspergillus_fumigatus_DMC2_AF100-1_4	43	35	8	0	scaffold_1	3276331	3376331
Aspergillus_fumigatus_DMC2_AF100-1_4	39	36	3	0	scaffold_8	1166397	1266397
Aspergillus_fumigatus_DMC2_AF100-1_4	38	34	4	0	scaffold_2	3366126	3466126
Aspergillus_fumigatus_DMC2_AF100-1_4	37	28	9	0	scaffold_2	2718784	2818784
Aspergillus_fumigatus_DMC2_AF100-1_4	31	30	1	0	scaffold_1	1339558	1439558
Aspergillus_fumigatus_DMC2_AF100-1_4	42	39	3	0	scaffold_1	3855037	3955037
Aspergillus_fumigatus_DMC2_AF100-1_4	35	32	3	0	scaffold_3	1353109	1453109
Aspergillus_fumigatus_DMC2_AF100-1_4	32	31	1	0	scaffold_5	3176484	3276484
Aspergillus_fumigatus_DMC2_AF100-1_4	37	26	11	0	scaffold_5	2805120	2905120
Aspergillus_fumigatus_DMC2_AF100-1_4	33	32	1	0	scaffold_5	1562263	1662263
Aspergillus_fumigatus_DMC2_AF100-1_4	38	38	0	0	scaffold_2	1677657	1777657
Aspergillus_fumigatus_DMC2_AF100-1_4	44	39	5	0	scaffold_3	1651908	1751908
Aspergillus_fumigatus_DMC2_AF100-1_4	36	34	2	0	scaffold_5	1456823	1556823
Aspergillus_fumigatus_DMC2_AF100-1_4	38	35	3	0	scaffold_1	4988606	5088606
Aspergillus_fumigatus_DMC2_AF100-1_4	45	37	8	0	scaffold_2	195409	295409
Aspergillus_fumigatus_DMC2_AF100-1_4	32	32	0	0	scaffold_1	2785077	2885077
Aspergillus_fumigatus_DMC2_AF100-1_4	34	28	6	0	scaffold_6	2071089	2171089
Aspergillus_fumigatus_DMC2_AF100-1_4	41	39	2	0	scaffold_5	630414	730414
Aspergillus_fumigatus_DMC2_AF100-1_4	39	29	10	0	scaffold_6	2103540	2203540
Aspergillus_fumigatus_DMC2_AF100-1_4	39	35	4	0	scaffold_8	244393	344393
Aspergillus_fumigatus_DMC2_AF100-1_4	38	33	5	0	scaffold_3	2064174	2164174
Aspergillus_fumigatus_DMC2_AF100-1_4	37	37	0	0	scaffold_2	4043723	4143723
Aspergillus_fumigatus_DMC2_AF100-1_4	32	29	3	0	scaffold_1	4062313	4162313
Aspergillus_fumigatus_DMC2_AF100-1_4	43	39	4	0	scaffold_8	116233	216233
Aspergillus_fumigatus_DMC2_AF100-1_4	32	26	6	0	scaffold_3	1856261	1956261
Aspergillus_fumigatus_DMC2_AF100-1_4	41	33	8	0	scaffold_7	1551886	1651886
Aspergillus_fumigatus_DMC2_AF100-1_4	38	37	1	0	scaffold_4	553420	653420
Aspergillus_fumigatus_DMC2_AF100-1_4	34	32	2	0	scaffold_5	2666493	2766493
Aspergillus_fumigatus_DMC2_AF100-1_4	36	28	8	0	scaffold_5	2761990	2861990
Aspergillus_fumigatus_DMC2_AF100-1_4	29	27	2	0	scaffold_5	2023810	2123810
Aspergillus_fumigatus_DMC2_AF100-1_4	38	36	2	0	scaffold_6	1433986	1533986
Aspergillus_fumigatus_DMC2_AF100-1_4	29	11	18	0	scaffold_3	761775	861775
Aspergillus_fumigatus_DMC2_AF100-1_4	39	35	4	0	scaffold_2	2323866	2423866
Aspergillus_fumigatus_DMC2_AF100-1_4	42	36	6	0	scaffold_3	2840478	2940478
Aspergillus_fumigatus_DMC2_AF100-1_4	25	25	0	0	scaffold_7	639184	739184
Aspergillus_fumigatus_DMC2_AF100-1_4	41	40	1	0	scaffold_2	1759207	1859207
Aspergillus_fumigatus_DMC2_AF100-1_4	40	38	2	0	scaffold_2	3676740	3776740
Aspergillus_fumigatus_DMC2_AF100-1_4	30	27	3	0	scaffold_5	1667490	1767490
Aspergillus_fumigatus_DMC2_AF100-1_4	40	35	5	0	scaffold_8	1334451	1434451
Aspergillus_fumigatus_DMC2_AF100-1_4	43	40	3	0	scaffold_7	1590193	1690193
Aspergillus_fumigatus_DMC2_AF100-1_4	35	35	0	0	scaffold_5	3109152	3209152
Aspergillus_fumigatus_DMC2_AF100-1_4	36	32	4	0	scaffold_5	1790629	1890629
Aspergillus_fumigatus_DMC2_AF100-1_4	29	24	5	0	scaffold_1	1765410	1865410
Aspergillus_fumigatus_DMC2_AF100-1_4	37	35	2	0	scaffold_6	1484290	1584290
Aspergillus_fumigatus_DMC2_AF100-1_4	35	32	3	0	scaffold_4	1545510	1645510
Aspergillus_fumigatus_DMC2_AF100-1_4	48	42	6	0	scaffold_3	536797	636797
Aspergillus_fumigatus_DMC2_AF100-1_4	46	43	3	0	scaffold_3	4040406	4140406
Aspergillus_fumigatus_DMC2_AF100-1_4	42	41	1	0	scaffold_3	3961020	4061020
Aspergillus_fumigatus_DMC2_AF100-1_4	32	31	1	0	scaffold_1	1609056	1709056
Aspergillus_fumigatus_DMC2_AF100-1_4	8	8	0	0	scaffold_3	1264827	1364827
Aspergillus_fumigatus_DMC2_AF100-1_4	40	36	4	0	scaffold_5	3370221	3470221
Aspergillus_fumigatus_DMC2_AF100-1_4	32	31	1	0	scaffold_5	2558550	2658550
Aspergillus_fumigatus_DMC2_AF100-1_4	45	40	5	0	scaffold_3	2397226	2497226
Aspergillus_fumigatus_DMC2_AF100-1_4	33	31	2	0	scaffold_3	2880340	2980340
Aspergillus_fumigatus_DMC2_AF100-1_4	43	39	4	0	scaffold_4	313305	413305
Aspergillus_fumigatus_DMC2_AF100-1_4	42	39	3	0	scaffold_1	4968912	5068912
Aspergillus_fumigatus_DMC2_AF100-1_4	44	39	5	0	scaffold_6	3339854	3439854
Aspergillus_fumigatus_DMC2_AF100-1_4	40	34	6	0	scaffold_6	229945	329945
Aspergillus_fumigatus_DMC2_AF100-1_4	35	32	3	0	scaffold_1	3765057	3865057
Aspergillus_fumigatus_DMC2_AF100-1_4	31	28	3	0	scaffold_6	55035	155035
Aspergillus_fumigatus_DMC2_AF100-1_4	34	32	2	0	scaffold_6	3082635	3182635
Aspergillus_fumigatus_DMC2_AF100-1_4	37	32	5	0	scaffold_3	2027840	2127840
Aspergillus_fumigatus_DMC2_AF100-1_4	41	39	2	0	scaffold_5	1905421	2005421
Aspergillus_fumigatus_DMC2_AF100-1_4	39	36	3	0	scaffold_2	2445016	2545016
Aspergillus_fumigatus_DMC2_AF100-1_4	37	35	2	0	scaffold_1	488917	588917
Aspergillus_fumigatus_DMC2_AF100-1_4	23	2	21	0	scaffold_7	1873841	1973841
Aspergillus_fumigatus_DMC2_AF100-1_4	40	36	4	0	scaffold_4	2384786	2484786
Aspergillus_fumigatus_DMC2_AF100-1_4	38	35	3	0	scaffold_4	1793282	1893282
Aspergillus_fumigatus_DMC2_AF100-1_4	35	34	1	0	scaffold_2	3248813	3348813
Aspergillus_fumigatus_DMC2_AF100-1_4	34	30	4	0	scaffold_6	2376658	2476658
Aspergillus_fumigatus_DMC2_AF100-1_4	20	15	5	0	scaffold_5	2065328	2165328
Aspergillus_fumigatus_DMC2_AF100-1_4	44	39	5	0	scaffold_2	2167567	2267567
Aspergillus_fumigatus_DMC2_AF100-1_4	30	28	2	0	scaffold_6	1377651	1477651
Aspergillus_fumigatus_DMC2_AF100-1_4	35	35	0	0	scaffold_4	2298020	2398020
Aspergillus_fumigatus_DMC2_AF100-1_4	37	35	2	0	scaffold_4	870036	970036
Aspergillus_fumigatus_DMC2_AF100-1_4	42	39	3	0	scaffold_5	607709	707709
Aspergillus_fumigatus_DMC2_AF100-1_4	38	32	6	0	scaffold_1	4017525	4117525
Aspergillus_fumigatus_DMC2_AF100-1_4	29	28	1	0	scaffold_6	2594641	2694641
Aspergillus_fumigatus_DMC2_AF100-1_4	40	39	1	0	scaffold_1	528023	628023
Aspergillus_fumigatus_DMC2_AF100-1_4	33	29	4	0	scaffold_1	1070715	1170715
Aspergillus_fumigatus_DMC2_AF100-1_4	40	37	3	0	scaffold_2	3673026	3773026
Aspergillus_fumigatus_DMC2_AF100-1_4	32	32	0	0	scaffold_2	4004760	4104760
Aspergillus_fumigatus_DMC2_AF100-1_4	6	6	0	0	scaffold_6	1045709	1145709
Aspergillus_fumigatus_DMC2_AF100-1_4	44	34	10	0	scaffold_6	274828	374828
Aspergillus_fumigatus_DMC2_AF100-1_4	35	31	4	0	scaffold_1	3025332	3125332
Aspergillus_fumigatus_DMC2_AF100-1_4	24	21	3	0	scaffold_5	1080084	1180084
Aspergillus_fumigatus_DMC2_AF100-1_4	43	37	6	0	scaffold_7	1129943	1229943
Aspergillus_fumigatus_DMC2_AF100-1_4	43	39	4	0	scaffold_8	158581	258581
Aspergillus_fumigatus_DMC2_AF100-1_4	33	31	2	0	scaffold_2	832823	932823
Aspergillus_fumigatus_DMC2_AF100-1_4	37	34	3	0	scaffold_5	1864138	1964138
Aspergillus_fumigatus_DMC2_AF100-1_4	37	30	7	0	scaffold_1	4359405	4459405
Aspergillus_fumigatus_DMC2_AF100-1_4	41	36	5	0	scaffold_2	2144536	2244536
Aspergillus_fumigatus_DMC2_AF100-1_4	47	43	4	0	scaffold_1	3885299	3985299
Aspergillus_fumigatus_DMC2_AF100-1_4	39	34	5	0	scaffold_7	340209	440209
Aspergillus_fumigatus_DMC2_AF100-1_4	36	32	4	0	scaffold_8	1310427	1410427
Aspergillus_fumigatus_DMC2_AF100-1_4	49	37	12	0	scaffold_1	49917	149917
Aspergillus_fumigatus_DMC2_AF100-1_4	40	34	6	0	scaffold_4	1636873	1736873
Aspergillus_fumigatus_DMC2_AF100-1_4	36	34	2	0	scaffold_4	407241	507241
Aspergillus_fumigatus_DMC2_AF100-1_4	35	31	4	0	scaffold_1	3636157	3736157
Aspergillus_fumigatus_DMC2_AF100-1_4	34	31	3	0	scaffold_6	2277291	2377291
Aspergillus_fumigatus_DMC2_AF100-1_4	6	6	0	0	scaffold_1	1901948	2001948
Aspergillus_fumigatus_DMC2_AF100-1_4	40	14	26	0	scaffold_1	4781398	4881398
Aspergillus_fumigatus_DMC2_AF100-1_4	38	33	5	0	scaffold_1	1463828	1563828
Aspergillus_fumigatus_DMC2_AF100-1_4	37	34	3	0	scaffold_3	2862016	2962016
Aspergillus_fumigatus_DMC2_AF100-1_4	33	31	2	0	scaffold_3	3101241	3201241
Aspergillus_fumigatus_DMC2_AF100-1_4	30	30	0	0	scaffold_6	2546959	2646959
Aspergillus_fumigatus_DMC2_AF100-1_4	33	33	0	0	scaffold_1	2580650	2680650
Aspergillus_fumigatus_DMC2_AF100-1_4	42	34	8	0	scaffold_3	1056621	1156621
Aspergillus_fumigatus_DMC2_AF100-1_4	45	34	11	0	scaffold_1	4281413	4381413
Aspergillus_fumigatus_DMC2_AF100-1_4	41	37	4	0	scaffold_5	2324182	2424182
Aspergillus_fumigatus_DMC2_AF100-1_4	41	36	5	0	scaffold_8	60763	160763
Aspergillus_fumigatus_DMC2_AF100-1_4	38	35	3	0	scaffold_2	4173055	4273055
Aspergillus_fumigatus_DMC2_AF100-1_4	34	32	2	0	scaffold_1	2637432	2737432
Aspergillus_fumigatus_DMC2_AF100-1_4	9	1	8	0	scaffold_2	89359	189359
Aspergillus_fumigatus_DMC2_AF100-1_4	29	24	5	0	scaffold_6	479903	579903
Aspergillus_fumigatus_DMC2_AF100-1_4	40	38	2	0	scaffold_6	1546106	1646106
Aspergillus_fumigatus_DMC2_AF100-1_4	41	39	2	0	scaffold_3	293873	393873
Aspergillus_fumigatus_DMC2_AF100-1_4	33	32	1	0	scaffold_3	2908220	3008220
Aspergillus_fumigatus_DMC2_AF100-1_4	37	32	5	0	scaffold_1	1457043	1557043
Aspergillus_fumigatus_DMC2_AF100-1_4	42	34	8	0	scaffold_1	3280733	3380733
Aspergillus_fumigatus_DMC2_AF100-1_4	41	36	5	0	scaffold_1	3438542	3538542
Aspergillus_fumigatus_DMC2_AF100-1_4	43	38	5	0	scaffold_3	1114564	1214564
Aspergillus_fumigatus_DMC2_AF100-1_4	37	33	4	0	scaffold_2	1546441	1646441
Aspergillus_fumigatus_DMC2_AF100-1_4	40	37	3	0	scaffold_2	3662775	3762775
Aspergillus_fumigatus_DMC2_AF100-1_4	16	14	2	0	scaffold_4	1176039	1276039
Aspergillus_fumigatus_DMC2_AF100-1_4	39	36	3	0	scaffold_2	2277260	2377260
Aspergillus_fumigatus_DMC2_AF100-1_4	32	27	5	0	scaffold_5	102677	202677
Aspergillus_fumigatus_DMC2_AF100-1_4	34	32	1	1	scaffold_3	3516560	3616560
Aspergillus_fumigatus_DMC2_AF100-1_4	39	34	5	0	scaffold_1	300542	400542
Aspergillus_fumigatus_DMC2_AF100-1_4	41	34	7	0	scaffold_1	4677710	4777710
Aspergillus_fumigatus_DMC2_AF100-1_4	37	33	4	0	scaffold_2	649949	749949
Aspergillus_fumigatus_DMC2_AF100-1_4	46	41	5	0	scaffold_3	1140717	1240717
Aspergillus_fumigatus_DMC2_AF100-1_4	34	28	6	0	scaffold_6	2068821	2168821
Aspergillus_fumigatus_DMC2_AF100-1_4	32	32	0	0	scaffold_1	782812	882812
Aspergillus_fumigatus_DMC2_AF100-1_4	27	26	1	0	scaffold_4	1942807	2042807
Aspergillus_fumigatus_DMC2_AF100-1_4	31	30	1	0	scaffold_5	3192091	3292091
Aspergillus_fumigatus_DMC2_AF100-1_4	40	37	3	0	scaffold_2	3553841	3653841
Aspergillus_fumigatus_DMC2_AF100-1_4	37	34	3	0	scaffold_3	333924	433924
Aspergillus_fumigatus_DMC2_AF100-1_4	33	29	4	0	scaffold_2	3141219	3241219
Aspergillus_fumigatus_DMC2_AF100-1_4	40	33	7	0	scaffold_1	3962314	4062314
Aspergillus_fumigatus_DMC2_AF100-1_4	34	27	7	0	scaffold_1	3574987	3674987
Aspergillus_fumigatus_DMC2_AF100-1_4	36	36	0	0	scaffold_6	2886489	2986489
Aspergillus_fumigatus_DMC2_AF100-1_4	33	15	18	0	scaffold_3	641766	741766
Aspergillus_fumigatus_DMC2_AF100-1_4	40	36	4	0	scaffold_3	355013	455013
Aspergillus_fumigatus_DMC2_AF100-1_4	33	2	31	0	scaffold_1	4475034	4575034
Aspergillus_fumigatus_DMC2_AF100-1_4	15	12	3	0	scaffold_4	2178265	2278265
Aspergillus_fumigatus_DMC2_AF100-1_4	25	22	3	0	scaffold_7	1260610	1360610
Aspergillus_fumigatus_DMC2_AF100-1_4	26	23	3	0	scaffold_5	1150809	1250809
Aspergillus_fumigatus_DMC2_AF100-1_4	50	41	9	0	scaffold_4	3688182	3788182
Aspergillus_fumigatus_DMC2_AF100-1_4	28	27	1	0	scaffold_1	1977835	2077835
Aspergillus_fumigatus_DMC2_AF100-1_4	35	32	3	0	scaffold_1	1427899	1527899
Aspergillus_fumigatus_DMC2_AF100-1_4	30	29	1	0	scaffold_6	2505500	2605500
Aspergillus_fumigatus_DMC2_AF100-1_4	41	38	3	0	scaffold_6	759164	859164
Aspergillus_fumigatus_DMC2_AF100-1_4	48	29	19	0	scaffold_6	297657	397657
Aspergillus_fumigatus_DMC2_AF100-1_4	34	28	6	0	scaffold_3	823391	923391
Aspergillus_fumigatus_DMC2_AF100-1_4	28	25	3	0	scaffold_4	56370	156370
Aspergillus_fumigatus_DMC2_AF100-1_4	38	27	11	0	scaffold_5	2802318	2902318
Aspergillus_fumigatus_DMC2_AF100-1_4	35	32	3	0	scaffold_5	2953631	3053631
Aspergillus_fumigatus_DMC2_AF100-1_4	34	31	3	0	scaffold_4	2416675	2516675
Aspergillus_fumigatus_DMC2_AF100-1_4	37	33	4	0	scaffold_4	1279101	1379101
Aspergillus_fumigatus_DMC2_AF100-1_4	33	30	3	0	scaffold_5	2891315	2991315
Aspergillus_fumigatus_DMC2_AF100-1_4	21	20	1	0	scaffold_1	1958851	2058851
Aspergillus_fumigatus_DMC2_AF100-1_4	35	25	10	0	scaffold_5	2809269	2909269
Aspergillus_fumigatus_DMC2_AF100-1_4	31	28	3	0	scaffold_5	1324032	1424032
Aspergillus_fumigatus_DMC2_AF100-1_4	39	36	3	0	scaffold_2	1394406	1494406
