STRAIN	TOTAL	CORE	ACCESSORY	SINGLETON	CHROM	START	END
Aspergillus_fumigatus_AFIS_23107_CDC-12	40	35	5	0	scaffold_7	1167993	1267993
Aspergillus_fumigatus_AFIS_23107_CDC-12	32	29	3	0	scaffold_1	4762962	4862962
Aspergillus_fumigatus_AFIS_23107_CDC-12	41	40	1	0	scaffold_7	876120	976120
Aspergillus_fumigatus_AFIS_23107_CDC-12	33	30	3	0	scaffold_3	2087060	2187060
Aspergillus_fumigatus_AFIS_23107_CDC-12	41	37	4	0	scaffold_3	2435610	2535610
Aspergillus_fumigatus_AFIS_23107_CDC-12	41	37	4	0	scaffold_3	2646147	2746147
Aspergillus_fumigatus_AFIS_23107_CDC-12	35	31	4	0	scaffold_8	987887	1087887
Aspergillus_fumigatus_AFIS_23107_CDC-12	36	34	2	0	scaffold_6	1133700	1233700
Aspergillus_fumigatus_AFIS_23107_CDC-12	35	34	1	0	scaffold_6	2572436	2672436
Aspergillus_fumigatus_AFIS_23107_CDC-12	34	32	2	0	scaffold_5	3315577	3415577
Aspergillus_fumigatus_AFIS_23107_CDC-12	38	33	5	0	scaffold_1	761036	861036
Aspergillus_fumigatus_AFIS_23107_CDC-12	42	37	5	0	scaffold_1	1872060	1972060
Aspergillus_fumigatus_AFIS_23107_CDC-12	34	31	3	0	scaffold_1	4510510	4610510
Aspergillus_fumigatus_AFIS_23107_CDC-12	32	29	3	0	scaffold_1	2773065	2873065
Aspergillus_fumigatus_AFIS_23107_CDC-12	33	33	0	0	scaffold_5	2928418	3028418
Aspergillus_fumigatus_AFIS_23107_CDC-12	41	41	0	0	scaffold_3	1093927	1193927
Aspergillus_fumigatus_AFIS_23107_CDC-12	31	30	1	0	scaffold_1	4448787	4548787
Aspergillus_fumigatus_AFIS_23107_CDC-12	35	32	3	0	scaffold_2	3730867	3830867
Aspergillus_fumigatus_AFIS_23107_CDC-12	45	36	9	0	scaffold_7	1125472	1225472
Aspergillus_fumigatus_AFIS_23107_CDC-12	49	41	8	0	scaffold_6	529377	629377
Aspergillus_fumigatus_AFIS_23107_CDC-12	36	33	3	0	scaffold_4	1938917	2038917
Aspergillus_fumigatus_AFIS_23107_CDC-12	32	30	2	0	scaffold_1	1365935	1465935
Aspergillus_fumigatus_AFIS_23107_CDC-12	42	37	5	0	scaffold_2	302868	402868
Aspergillus_fumigatus_AFIS_23107_CDC-12	38	33	5	0	scaffold_2	4006280	4106280
Aspergillus_fumigatus_AFIS_23107_CDC-12	15	14	1	0	scaffold_2	1818877	1918877
Aspergillus_fumigatus_AFIS_23107_CDC-12	39	37	2	0	scaffold_4	2923250	3023250
Aspergillus_fumigatus_AFIS_23107_CDC-12	50	35	15	0	scaffold_4	3435761	3535761
Aspergillus_fumigatus_AFIS_23107_CDC-12	40	37	3	0	scaffold_5	783405	883405
Aspergillus_fumigatus_AFIS_23107_CDC-12	33	31	2	0	scaffold_2	3619354	3719354
Aspergillus_fumigatus_AFIS_23107_CDC-12	44	40	4	0	scaffold_4	2147461	2247461
Aspergillus_fumigatus_AFIS_23107_CDC-12	39	38	1	0	scaffold_1	1652805	1752805
Aspergillus_fumigatus_AFIS_23107_CDC-12	36	27	9	0	scaffold_2	4605971	4705971
Aspergillus_fumigatus_AFIS_23107_CDC-12	38	32	6	0	scaffold_8	391947	491947
Aspergillus_fumigatus_AFIS_23107_CDC-12	42	39	3	0	scaffold_2	4771336	4871336
Aspergillus_fumigatus_AFIS_23107_CDC-12	15	1	14	0	scaffold_1	110448	210448
Aspergillus_fumigatus_AFIS_23107_CDC-12	38	36	2	0	scaffold_2	2204004	2304004
Aspergillus_fumigatus_AFIS_23107_CDC-12	40	38	2	0	scaffold_3	389360	489360
Aspergillus_fumigatus_AFIS_23107_CDC-12	35	33	2	0	scaffold_6	1078837	1178837
Aspergillus_fumigatus_AFIS_23107_CDC-12	53	42	11	0	scaffold_3	3765249	3865249
Aspergillus_fumigatus_AFIS_23107_CDC-12	41	38	3	0	scaffold_6	2100566	2200566
Aspergillus_fumigatus_AFIS_23107_CDC-12	38	34	4	0	scaffold_3	1354364	1454364
Aspergillus_fumigatus_AFIS_23107_CDC-12	42	39	3	0	scaffold_8	1325892	1425892
Aspergillus_fumigatus_AFIS_23107_CDC-12	32	3	29	0	scaffold_4	667400	767400
Aspergillus_fumigatus_AFIS_23107_CDC-12	41	39	2	0	scaffold_2	3818914	3918914
Aspergillus_fumigatus_AFIS_23107_CDC-12	38	29	9	0	scaffold_1	3949715	4049715
Aspergillus_fumigatus_AFIS_23107_CDC-12	44	35	9	0	scaffold_6	298059	398059
Aspergillus_fumigatus_AFIS_23107_CDC-12	44	38	6	0	scaffold_8	108799	208799
Aspergillus_fumigatus_AFIS_23107_CDC-12	43	41	2	0	scaffold_2	2131467	2231467
Aspergillus_fumigatus_AFIS_23107_CDC-12	35	30	5	0	scaffold_2	2835198	2935198
Aspergillus_fumigatus_AFIS_23107_CDC-12	34	34	0	0	scaffold_3	707870	807870
Aspergillus_fumigatus_AFIS_23107_CDC-12	36	35	1	0	scaffold_1	3310135	3410135
Aspergillus_fumigatus_AFIS_23107_CDC-12	39	38	1	0	scaffold_1	2075582	2175582
Aspergillus_fumigatus_AFIS_23107_CDC-12	46	40	6	0	scaffold_3	2621668	2721668
Aspergillus_fumigatus_AFIS_23107_CDC-12	28	25	3	0	scaffold_4	3170208	3270208
Aspergillus_fumigatus_AFIS_23107_CDC-12	36	31	5	0	scaffold_6	24694	124694
Aspergillus_fumigatus_AFIS_23107_CDC-12	15	15	0	0	scaffold_3	2164523	2264523
Aspergillus_fumigatus_AFIS_23107_CDC-12	18	16	2	0	scaffold_4	1127463	1227463
Aspergillus_fumigatus_AFIS_23107_CDC-12	42	37	5	0	scaffold_7	146765	246765
Aspergillus_fumigatus_AFIS_23107_CDC-12	34	31	3	0	scaffold_1	1116901	1216901
Aspergillus_fumigatus_AFIS_23107_CDC-12	38	35	3	0	scaffold_8	1157186	1257186
Aspergillus_fumigatus_AFIS_23107_CDC-12	21	17	4	0	scaffold_8	908392	1008392
Aspergillus_fumigatus_AFIS_23107_CDC-12	36	30	6	0	scaffold_4	883565	983565
Aspergillus_fumigatus_AFIS_23107_CDC-12	32	31	1	0	scaffold_4	2556290	2656290
Aspergillus_fumigatus_AFIS_23107_CDC-12	8	5	3	0	scaffold_3	25771	125771
Aspergillus_fumigatus_AFIS_23107_CDC-12	39	32	7	0	scaffold_4	2304661	2404661
Aspergillus_fumigatus_AFIS_23107_CDC-12	43	31	12	0	scaffold_3	3909968	4009968
Aspergillus_fumigatus_AFIS_23107_CDC-12	34	32	2	0	scaffold_5	2993436	3093436
Aspergillus_fumigatus_AFIS_23107_CDC-12	36	36	0	0	scaffold_4	1684266	1784266
Aspergillus_fumigatus_AFIS_23107_CDC-12	36	34	2	0	scaffold_1	797985	897985
Aspergillus_fumigatus_AFIS_23107_CDC-12	34	34	0	0	scaffold_4	1636263	1736263
Aspergillus_fumigatus_AFIS_23107_CDC-12	32	29	3	0	scaffold_1	4247353	4347353
Aspergillus_fumigatus_AFIS_23107_CDC-12	38	37	1	0	scaffold_8	1129145	1229145
Aspergillus_fumigatus_AFIS_23107_CDC-12	36	36	0	0	scaffold_2	549796	649796
Aspergillus_fumigatus_AFIS_23107_CDC-12	37	33	4	0	scaffold_1	567710	667710
Aspergillus_fumigatus_AFIS_23107_CDC-12	44	36	8	0	scaffold_6	255673	355673
Aspergillus_fumigatus_AFIS_23107_CDC-12	32	29	3	0	scaffold_8	1411660	1511660
Aspergillus_fumigatus_AFIS_23107_CDC-12	36	34	2	0	scaffold_1	3490441	3590441
Aspergillus_fumigatus_AFIS_23107_CDC-12	37	32	5	0	scaffold_1	4589218	4689218
Aspergillus_fumigatus_AFIS_23107_CDC-12	41	34	7	0	scaffold_2	3255344	3355344
Aspergillus_fumigatus_AFIS_23107_CDC-12	34	29	5	0	scaffold_4	1746854	1846854
Aspergillus_fumigatus_AFIS_23107_CDC-12	42	38	4	0	scaffold_5	1783636	1883636
Aspergillus_fumigatus_AFIS_23107_CDC-12	30	30	0	0	scaffold_2	1490699	1590699
Aspergillus_fumigatus_AFIS_23107_CDC-12	45	43	2	0	scaffold_4	3738408	3838408
Aspergillus_fumigatus_AFIS_23107_CDC-12	36	29	7	0	scaffold_2	3584423	3684423
Aspergillus_fumigatus_AFIS_23107_CDC-12	36	33	3	0	scaffold_4	3009298	3109298
Aspergillus_fumigatus_AFIS_23107_CDC-12	47	43	4	0	scaffold_1	4629379	4729379
Aspergillus_fumigatus_AFIS_23107_CDC-12	37	34	3	0	scaffold_1	1538222	1638222
Aspergillus_fumigatus_AFIS_23107_CDC-12	36	35	1	0	scaffold_4	2859057	2959057
Aspergillus_fumigatus_AFIS_23107_CDC-12	9	0	9	0	scaffold_7	1829641	1929641
Aspergillus_fumigatus_AFIS_23107_CDC-12	44	37	7	0	scaffold_3	331495	431495
Aspergillus_fumigatus_AFIS_23107_CDC-12	26	4	22	0	scaffold_4	687631	787631
Aspergillus_fumigatus_AFIS_23107_CDC-12	33	29	4	0	scaffold_1	3662248	3762248
Aspergillus_fumigatus_AFIS_23107_CDC-12	37	37	0	0	scaffold_3	3249045	3349045
Aspergillus_fumigatus_AFIS_23107_CDC-12	40	31	9	0	scaffold_7	353926	453926
Aspergillus_fumigatus_AFIS_23107_CDC-12	35	34	1	0	scaffold_3	2842093	2942093
Aspergillus_fumigatus_AFIS_23107_CDC-12	39	33	6	0	scaffold_1	748693	848693
Aspergillus_fumigatus_AFIS_23107_CDC-12	39	39	0	0	scaffold_5	3411942	3511942
Aspergillus_fumigatus_AFIS_23107_CDC-12	37	24	13	0	scaffold_4	839722	939722
Aspergillus_fumigatus_AFIS_23107_CDC-12	50	41	9	0	scaffold_4	468226	568226
Aspergillus_fumigatus_AFIS_23107_CDC-12	15	0	15	0	scaffold_7	1870896	1970896
Aspergillus_fumigatus_AFIS_23107_CDC-12	33	31	2	0	scaffold_7	1229677	1329677
Aspergillus_fumigatus_AFIS_23107_CDC-12	32	31	1	0	scaffold_6	2760319	2860319
Aspergillus_fumigatus_AFIS_23107_CDC-12	43	42	1	0	scaffold_7	1407523	1507523
Aspergillus_fumigatus_AFIS_23107_CDC-12	35	30	5	0	scaffold_2	1073269	1173269
Aspergillus_fumigatus_AFIS_23107_CDC-12	46	38	8	0	scaffold_6	475033	575033
Aspergillus_fumigatus_AFIS_23107_CDC-12	38	34	4	0	scaffold_6	1537520	1637520
Aspergillus_fumigatus_AFIS_23107_CDC-12	45	38	7	0	scaffold_4	3405539	3505539
Aspergillus_fumigatus_AFIS_23107_CDC-12	37	35	2	0	scaffold_3	899387	999387
Aspergillus_fumigatus_AFIS_23107_CDC-12	39	32	7	0	scaffold_8	1634151	1734151
Aspergillus_fumigatus_AFIS_23107_CDC-12	35	32	3	0	scaffold_2	1540388	1640388
Aspergillus_fumigatus_AFIS_23107_CDC-12	32	31	1	0	scaffold_1	4369482	4469482
Aspergillus_fumigatus_AFIS_23107_CDC-12	37	34	3	0	scaffold_6	2041578	2141578
Aspergillus_fumigatus_AFIS_23107_CDC-12	33	32	1	0	scaffold_1	4723698	4823698
Aspergillus_fumigatus_AFIS_23107_CDC-12	44	43	1	0	scaffold_6	1423211	1523211
Aspergillus_fumigatus_AFIS_23107_CDC-12	34	30	4	0	scaffold_2	1590499	1690499
Aspergillus_fumigatus_AFIS_23107_CDC-12	26	26	0	0	scaffold_6	920681	1020681
Aspergillus_fumigatus_AFIS_23107_CDC-12	37	31	6	0	scaffold_1	1858318	1958318
Aspergillus_fumigatus_AFIS_23107_CDC-12	42	39	3	0	scaffold_1	3153614	3253614
Aspergillus_fumigatus_AFIS_23107_CDC-12	33	30	3	0	scaffold_8	1413401	1513401
Aspergillus_fumigatus_AFIS_23107_CDC-12	48	44	4	0	scaffold_6	561049	661049
Aspergillus_fumigatus_AFIS_23107_CDC-12	31	31	0	0	scaffold_5	546970	646970
Aspergillus_fumigatus_AFIS_23107_CDC-12	33	32	1	0	scaffold_5	3321188	3421188
Aspergillus_fumigatus_AFIS_23107_CDC-12	35	32	3	0	scaffold_3	2481100	2581100
Aspergillus_fumigatus_AFIS_23107_CDC-12	32	30	2	0	scaffold_4	1574943	1674943
Aspergillus_fumigatus_AFIS_23107_CDC-12	32	27	5	0	scaffold_8	547328	647328
Aspergillus_fumigatus_AFIS_23107_CDC-12	32	27	5	0	scaffold_4	2344044	2444044
Aspergillus_fumigatus_AFIS_23107_CDC-12	38	34	4	0	scaffold_3	1349331	1449331
Aspergillus_fumigatus_AFIS_23107_CDC-12	38	37	1	0	scaffold_6	2530686	2630686
Aspergillus_fumigatus_AFIS_23107_CDC-12	37	34	3	0	scaffold_1	4501030	4601030
Aspergillus_fumigatus_AFIS_23107_CDC-12	36	36	0	0	scaffold_3	2358491	2458491
Aspergillus_fumigatus_AFIS_23107_CDC-12	42	36	6	0	scaffold_3	113889	213889
Aspergillus_fumigatus_AFIS_23107_CDC-12	35	31	4	0	scaffold_4	2372640	2472640
Aspergillus_fumigatus_AFIS_23107_CDC-12	34	32	2	0	scaffold_1	944429	1044429
Aspergillus_fumigatus_AFIS_23107_CDC-12	34	28	6	0	scaffold_2	2907188	3007188
Aspergillus_fumigatus_AFIS_23107_CDC-12	40	39	1	0	scaffold_6	836081	936081
Aspergillus_fumigatus_AFIS_23107_CDC-12	27	23	4	0	scaffold_8	577114	677114
Aspergillus_fumigatus_AFIS_23107_CDC-12	35	30	5	0	scaffold_7	30267	130267
Aspergillus_fumigatus_AFIS_23107_CDC-12	49	42	7	0	scaffold_4	514348	614348
Aspergillus_fumigatus_AFIS_23107_CDC-12	38	36	2	0	scaffold_6	1164611	1264611
Aspergillus_fumigatus_AFIS_23107_CDC-12	30	25	5	0	scaffold_5	262751	362751
Aspergillus_fumigatus_AFIS_23107_CDC-12	19	17	2	0	scaffold_7	724523	824523
Aspergillus_fumigatus_AFIS_23107_CDC-12	47	43	4	0	scaffold_6	617438	717438
Aspergillus_fumigatus_AFIS_23107_CDC-12	24	0	24	0	scaffold_7	1897912	1997912
Aspergillus_fumigatus_AFIS_23107_CDC-12	38	33	5	0	scaffold_5	2141961	2241961
Aspergillus_fumigatus_AFIS_23107_CDC-12	50	39	11	0	scaffold_7	1505748	1605748
Aspergillus_fumigatus_AFIS_23107_CDC-12	20	19	1	0	scaffold_8	865043	965043
Aspergillus_fumigatus_AFIS_23107_CDC-12	29	26	3	0	scaffold_4	3188660	3288660
Aspergillus_fumigatus_AFIS_23107_CDC-12	36	34	2	0	scaffold_6	2815172	2915172
Aspergillus_fumigatus_AFIS_23107_CDC-12	44	41	3	0	scaffold_2	3873321	3973321
Aspergillus_fumigatus_AFIS_23107_CDC-12	29	28	1	0	scaffold_1	4387185	4487185
Aspergillus_fumigatus_AFIS_23107_CDC-12	39	38	1	0	scaffold_1	2237139	2337139
Aspergillus_fumigatus_AFIS_23107_CDC-12	40	40	0	0	scaffold_1	482615	582615
Aspergillus_fumigatus_AFIS_23107_CDC-12	47	37	10	0	scaffold_7	215905	315905
Aspergillus_fumigatus_AFIS_23107_CDC-12	34	34	0	0	scaffold_3	706089	806089
Aspergillus_fumigatus_AFIS_23107_CDC-12	35	23	12	0	scaffold_4	3407	103407
Aspergillus_fumigatus_AFIS_23107_CDC-12	38	33	5	0	scaffold_3	448257	548257
Aspergillus_fumigatus_AFIS_23107_CDC-12	37	31	6	0	scaffold_7	1037696	1137696
Aspergillus_fumigatus_AFIS_23107_CDC-12	39	37	2	0	scaffold_2	2565104	2665104
Aspergillus_fumigatus_AFIS_23107_CDC-12	36	33	3	0	scaffold_2	1209859	1309859
Aspergillus_fumigatus_AFIS_23107_CDC-12	44	43	1	0	scaffold_4	1459975	1559975
Aspergillus_fumigatus_AFIS_23107_CDC-12	38	36	2	0	scaffold_4	2915966	3015966
Aspergillus_fumigatus_AFIS_23107_CDC-12	33	29	4	0	scaffold_2	1106592	1206592
Aspergillus_fumigatus_AFIS_23107_CDC-12	44	41	3	0	scaffold_2	4727610	4827610
Aspergillus_fumigatus_AFIS_23107_CDC-12	33	31	2	0	scaffold_3	1577072	1677072
Aspergillus_fumigatus_AFIS_23107_CDC-12	30	15	15	0	scaffold_5	357019	457019
Aspergillus_fumigatus_AFIS_23107_CDC-12	32	31	1	0	scaffold_4	1594030	1694030
Aspergillus_fumigatus_AFIS_23107_CDC-12	30	29	1	0	scaffold_1	2834048	2934048
Aspergillus_fumigatus_AFIS_23107_CDC-12	39	35	4	0	scaffold_8	1255519	1355519
Aspergillus_fumigatus_AFIS_23107_CDC-12	34	29	5	0	scaffold_4	894288	994288
Aspergillus_fumigatus_AFIS_23107_CDC-12	42	41	1	0	scaffold_4	1439761	1539761
Aspergillus_fumigatus_AFIS_23107_CDC-12	35	33	2	0	scaffold_4	2715753	2815753
Aspergillus_fumigatus_AFIS_23107_CDC-12	42	37	5	0	scaffold_5	2709328	2809328
Aspergillus_fumigatus_AFIS_23107_CDC-12	42	35	7	0	scaffold_4	1028268	1128268
Aspergillus_fumigatus_AFIS_23107_CDC-12	34	30	4	0	scaffold_7	1305847	1405847
Aspergillus_fumigatus_AFIS_23107_CDC-12	33	33	0	0	scaffold_4	2849812	2949812
Aspergillus_fumigatus_AFIS_23107_CDC-12	41	37	4	0	scaffold_2	3301902	3401902
Aspergillus_fumigatus_AFIS_23107_CDC-12	28	22	6	0	scaffold_4	1070112	1170112
Aspergillus_fumigatus_AFIS_23107_CDC-12	37	33	4	0	scaffold_1	2758299	2858299
Aspergillus_fumigatus_AFIS_23107_CDC-12	49	35	14	0	scaffold_6	3301040	3401040
Aspergillus_fumigatus_AFIS_23107_CDC-12	32	29	3	0	scaffold_1	1126008	1226008
Aspergillus_fumigatus_AFIS_23107_CDC-12	34	33	1	0	scaffold_2	2182834	2282834
Aspergillus_fumigatus_AFIS_23107_CDC-12	39	30	9	0	scaffold_8	1679376	1779376
Aspergillus_fumigatus_AFIS_23107_CDC-12	35	30	5	0	scaffold_2	2839779	2939779
Aspergillus_fumigatus_AFIS_23107_CDC-12	31	23	8	0	scaffold_6	165549	265549
Aspergillus_fumigatus_AFIS_23107_CDC-12	35	35	0	0	scaffold_2	567503	667503
Aspergillus_fumigatus_AFIS_23107_CDC-12	37	33	4	0	scaffold_8	258996	358996
Aspergillus_fumigatus_AFIS_23107_CDC-12	35	31	4	0	scaffold_2	1411249	1511249
Aspergillus_fumigatus_AFIS_23107_CDC-12	37	35	2	0	scaffold_6	809378	909378
Aspergillus_fumigatus_AFIS_23107_CDC-12	37	34	3	0	scaffold_4	1934821	2034821
Aspergillus_fumigatus_AFIS_23107_CDC-12	38	35	3	0	scaffold_5	1138372	1238372
Aspergillus_fumigatus_AFIS_23107_CDC-12	33	32	1	0	scaffold_2	3167073	3267073
Aspergillus_fumigatus_AFIS_23107_CDC-12	38	33	5	0	scaffold_5	2151538	2251538
Aspergillus_fumigatus_AFIS_23107_CDC-12	28	26	2	0	scaffold_2	1732406	1832406
Aspergillus_fumigatus_AFIS_23107_CDC-12	45	44	1	0	scaffold_6	1399034	1499034
Aspergillus_fumigatus_AFIS_23107_CDC-12	38	34	4	0	scaffold_5	1802762	1902762
Aspergillus_fumigatus_AFIS_23107_CDC-12	29	26	3	0	scaffold_3	2249964	2349964
Aspergillus_fumigatus_AFIS_23107_CDC-12	33	33	0	0	scaffold_4	1662319	1762319
Aspergillus_fumigatus_AFIS_23107_CDC-12	34	34	0	0	scaffold_5	2904120	3004120
Aspergillus_fumigatus_AFIS_23107_CDC-12	51	46	5	0	scaffold_1	267543	367543
Aspergillus_fumigatus_AFIS_23107_CDC-12	52	37	15	0	scaffold_2	77171	177171
Aspergillus_fumigatus_AFIS_23107_CDC-12	33	0	33	0	scaffold_2	4403608	4503608
Aspergillus_fumigatus_AFIS_23107_CDC-12	36	31	5	0	scaffold_2	2937860	3037860
Aspergillus_fumigatus_AFIS_23107_CDC-12	39	30	9	0	scaffold_8	1684887	1784887
Aspergillus_fumigatus_AFIS_23107_CDC-12	42	33	9	0	scaffold_6	1814969	1914969
Aspergillus_fumigatus_AFIS_23107_CDC-12	37	33	4	0	scaffold_1	4974607	5074607
Aspergillus_fumigatus_AFIS_23107_CDC-12	22	21	1	0	scaffold_3	1283409	1383409
Aspergillus_fumigatus_AFIS_23107_CDC-12	43	37	6	0	scaffold_3	3414491	3514491
Aspergillus_fumigatus_AFIS_23107_CDC-12	31	31	0	0	scaffold_6	2199250	2299250
Aspergillus_fumigatus_AFIS_23107_CDC-12	44	37	7	0	scaffold_3	331625	431625
Aspergillus_fumigatus_AFIS_23107_CDC-12	35	30	5	0	scaffold_8	985680	1085680
Aspergillus_fumigatus_AFIS_23107_CDC-12	33	30	3	0	scaffold_2	3631241	3731241
Aspergillus_fumigatus_AFIS_23107_CDC-12	38	35	3	0	scaffold_1	588786	688786
Aspergillus_fumigatus_AFIS_23107_CDC-12	40	35	5	0	scaffold_2	263466	363466
Aspergillus_fumigatus_AFIS_23107_CDC-12	37	35	2	0	scaffold_5	1051898	1151898
Aspergillus_fumigatus_AFIS_23107_CDC-12	37	32	5	0	scaffold_1	1584512	1684512
Aspergillus_fumigatus_AFIS_23107_CDC-12	31	29	2	0	scaffold_2	1909001	2009001
Aspergillus_fumigatus_AFIS_23107_CDC-12	36	8	28	0	scaffold_2	4324699	4424699
Aspergillus_fumigatus_AFIS_23107_CDC-12	35	33	2	0	scaffold_8	1388536	1488536
Aspergillus_fumigatus_AFIS_23107_CDC-12	28	27	1	0	scaffold_2	2703652	2803652
Aspergillus_fumigatus_AFIS_23107_CDC-12	20	18	2	0	scaffold_3	2120650	2220650
Aspergillus_fumigatus_AFIS_23107_CDC-12	41	30	11	0	scaffold_6	1776538	1876538
Aspergillus_fumigatus_AFIS_23107_CDC-12	23	21	2	0	scaffold_2	1754682	1854682
Aspergillus_fumigatus_AFIS_23107_CDC-12	36	33	3	0	scaffold_3	1926766	2026766
Aspergillus_fumigatus_AFIS_23107_CDC-12	39	37	2	0	scaffold_1	1704239	1804239
Aspergillus_fumigatus_AFIS_23107_CDC-12	45	37	8	0	scaffold_7	1156340	1256340
Aspergillus_fumigatus_AFIS_23107_CDC-12	35	30	5	0	scaffold_7	415785	515785
Aspergillus_fumigatus_AFIS_23107_CDC-12	40	37	3	0	scaffold_4	3349872	3449872
Aspergillus_fumigatus_AFIS_23107_CDC-12	39	37	2	0	scaffold_6	695029	795029
Aspergillus_fumigatus_AFIS_23107_CDC-12	37	32	5	0	scaffold_2	3939193	4039193
Aspergillus_fumigatus_AFIS_23107_CDC-12	41	35	6	0	scaffold_5	1744280	1844280
Aspergillus_fumigatus_AFIS_23107_CDC-12	40	35	5	0	scaffold_8	376922	476922
Aspergillus_fumigatus_AFIS_23107_CDC-12	34	32	2	0	scaffold_3	3473767	3573767
Aspergillus_fumigatus_AFIS_23107_CDC-12	40	37	3	0	scaffold_1	1205693	1305693
Aspergillus_fumigatus_AFIS_23107_CDC-12	40	37	3	0	scaffold_1	1205351	1305351
Aspergillus_fumigatus_AFIS_23107_CDC-12	39	30	9	0	scaffold_3	1761049	1861049
Aspergillus_fumigatus_AFIS_23107_CDC-12	38	34	4	0	scaffold_1	355052	455052
Aspergillus_fumigatus_AFIS_23107_CDC-12	33	29	4	0	scaffold_1	4525714	4625714
Aspergillus_fumigatus_AFIS_23107_CDC-12	37	31	6	0	scaffold_2	3015565	3115565
Aspergillus_fumigatus_AFIS_23107_CDC-12	44	24	20	0	scaffold_3	3577322	3677322
Aspergillus_fumigatus_AFIS_23107_CDC-12	35	35	0	0	scaffold_4	1640033	1740033
Aspergillus_fumigatus_AFIS_23107_CDC-12	40	34	6	0	scaffold_5	2661009	2761009
Aspergillus_fumigatus_AFIS_23107_CDC-12	24	22	2	0	scaffold_5	946935	1046935
Aspergillus_fumigatus_AFIS_23107_CDC-12	35	35	0	0	scaffold_5	3445649	3545649
Aspergillus_fumigatus_AFIS_23107_CDC-12	36	30	6	0	scaffold_5	3213970	3313970
Aspergillus_fumigatus_AFIS_23107_CDC-12	41	36	5	0	scaffold_8	1737658	1837658
Aspergillus_fumigatus_AFIS_23107_CDC-12	42	34	8	0	scaffold_3	3403608	3503608
Aspergillus_fumigatus_AFIS_23107_CDC-12	36	1	35	0	scaffold_7	1959938	2059938
Aspergillus_fumigatus_AFIS_23107_CDC-12	37	35	2	0	scaffold_1	795566	895566
Aspergillus_fumigatus_AFIS_23107_CDC-12	37	32	5	0	scaffold_1	1583234	1683234
Aspergillus_fumigatus_AFIS_23107_CDC-12	51	38	13	0	scaffold_5	29480	129480
Aspergillus_fumigatus_AFIS_23107_CDC-12	35	32	3	0	scaffold_3	2410146	2510146
Aspergillus_fumigatus_AFIS_23107_CDC-12	39	36	3	0	scaffold_6	1227968	1327968
Aspergillus_fumigatus_AFIS_23107_CDC-12	2	2	0	0	scaffold_4	2472821	2572821
Aspergillus_fumigatus_AFIS_23107_CDC-12	47	43	4	0	scaffold_1	227608	327608
Aspergillus_fumigatus_AFIS_23107_CDC-12	33	31	2	0	scaffold_5	3000223	3100223
Aspergillus_fumigatus_AFIS_23107_CDC-12	39	37	2	0	scaffold_3	2681670	2781670
Aspergillus_fumigatus_AFIS_23107_CDC-12	32	31	1	0	scaffold_6	2589418	2689418
Aspergillus_fumigatus_AFIS_23107_CDC-12	31	25	6	0	scaffold_6	198020	298020
Aspergillus_fumigatus_AFIS_23107_CDC-12	11	10	1	0	scaffold_1	2355817	2455817
Aspergillus_fumigatus_AFIS_23107_CDC-12	40	33	7	0	scaffold_4	58203	158203
Aspergillus_fumigatus_AFIS_23107_CDC-12	36	33	3	0	scaffold_3	2403330	2503330
Aspergillus_fumigatus_AFIS_23107_CDC-12	31	29	2	0	scaffold_3	3278842	3378842
Aspergillus_fumigatus_AFIS_23107_CDC-12	33	27	6	0	scaffold_2	3493596	3593596
Aspergillus_fumigatus_AFIS_23107_CDC-12	32	30	2	0	scaffold_1	1364991	1464991
Aspergillus_fumigatus_AFIS_23107_CDC-12	42	40	2	0	scaffold_2	4777356	4877356
Aspergillus_fumigatus_AFIS_23107_CDC-12	34	34	0	0	scaffold_3	2823774	2923774
Aspergillus_fumigatus_AFIS_23107_CDC-12	41	36	5	0	scaffold_8	93818	193818
Aspergillus_fumigatus_AFIS_23107_CDC-12	50	35	15	0	scaffold_4	3435980	3535980
Aspergillus_fumigatus_AFIS_23107_CDC-12	42	36	6	0	scaffold_5	2627299	2727299
Aspergillus_fumigatus_AFIS_23107_CDC-12	33	29	4	0	scaffold_1	3866134	3966134
Aspergillus_fumigatus_AFIS_23107_CDC-12	35	34	1	0	scaffold_3	725238	825238
Aspergillus_fumigatus_AFIS_23107_CDC-12	22	17	5	0	scaffold_5	1439809	1539809
Aspergillus_fumigatus_AFIS_23107_CDC-12	33	30	3	0	scaffold_6	768746	868746
Aspergillus_fumigatus_AFIS_23107_CDC-12	38	34	4	0	scaffold_1	2190606	2290606
Aspergillus_fumigatus_AFIS_23107_CDC-12	26	22	4	0	scaffold_8	944121	1044121
Aspergillus_fumigatus_AFIS_23107_CDC-12	37	37	0	0	scaffold_3	2714648	2814648
Aspergillus_fumigatus_AFIS_23107_CDC-12	34	28	6	0	scaffold_7	394965	494965
Aspergillus_fumigatus_AFIS_23107_CDC-12	34	32	2	0	scaffold_2	3111958	3211958
Aspergillus_fumigatus_AFIS_23107_CDC-12	41	35	6	0	scaffold_5	2610270	2710270
Aspergillus_fumigatus_AFIS_23107_CDC-12	35	33	2	0	scaffold_1	3249465	3349465
Aspergillus_fumigatus_AFIS_23107_CDC-12	45	41	4	0	scaffold_6	1849409	1949409
Aspergillus_fumigatus_AFIS_23107_CDC-12	40	37	3	0	scaffold_3	2932761	3032761
Aspergillus_fumigatus_AFIS_23107_CDC-12	4	4	0	0	scaffold_2	674449	774449
Aspergillus_fumigatus_AFIS_23107_CDC-12	41	38	3	0	scaffold_1	3351202	3451202
Aspergillus_fumigatus_AFIS_23107_CDC-12	50	46	4	0	scaffold_6	601540	701540
Aspergillus_fumigatus_AFIS_23107_CDC-12	32	32	0	0	scaffold_6	2928834	3028834
Aspergillus_fumigatus_AFIS_23107_CDC-12	29	26	3	0	scaffold_4	3188946	3288946
Aspergillus_fumigatus_AFIS_23107_CDC-12	42	36	6	0	scaffold_1	4809074	4909074
Aspergillus_fumigatus_AFIS_23107_CDC-12	37	33	4	0	scaffold_1	4975137	5075137
Aspergillus_fumigatus_AFIS_23107_CDC-12	27	26	1	0	scaffold_4	2537480	2637480
Aspergillus_fumigatus_AFIS_23107_CDC-12	43	34	9	0	scaffold_6	281472	381472
Aspergillus_fumigatus_AFIS_23107_CDC-12	37	36	1	0	scaffold_6	2423387	2523387
Aspergillus_fumigatus_AFIS_23107_CDC-12	26	23	3	0	scaffold_6	86215	186215
Aspergillus_fumigatus_AFIS_23107_CDC-12	36	32	4	0	scaffold_1	3421366	3521366
Aspergillus_fumigatus_AFIS_23107_CDC-12	32	30	2	0	scaffold_6	1684518	1784518
Aspergillus_fumigatus_AFIS_23107_CDC-12	32	21	11	0	scaffold_4	3526652	3626652
Aspergillus_fumigatus_AFIS_23107_CDC-12	39	38	1	0	scaffold_6	2974845	3074845
Aspergillus_fumigatus_AFIS_23107_CDC-12	35	32	3	0	scaffold_3	2478697	2578697
Aspergillus_fumigatus_AFIS_23107_CDC-12	33	31	2	0	scaffold_2	1896433	1996433
Aspergillus_fumigatus_AFIS_23107_CDC-12	35	35	0	0	scaffold_2	571843	671843
Aspergillus_fumigatus_AFIS_23107_CDC-12	36	1	35	0	scaffold_7	1959309	2059309
Aspergillus_fumigatus_AFIS_23107_CDC-12	27	22	5	0	scaffold_2	2044446	2144446
Aspergillus_fumigatus_AFIS_23107_CDC-12	46	42	4	0	scaffold_6	2995975	3095975
Aspergillus_fumigatus_AFIS_23107_CDC-12	31	29	2	0	scaffold_1	4262375	4362375
Aspergillus_fumigatus_AFIS_23107_CDC-12	44	39	5	0	scaffold_7	134145	234145
Aspergillus_fumigatus_AFIS_23107_CDC-12	36	32	4	0	scaffold_3	3526498	3626498
Aspergillus_fumigatus_AFIS_23107_CDC-12	34	31	3	0	scaffold_5	1923719	2023719
Aspergillus_fumigatus_AFIS_23107_CDC-12	38	35	3	0	scaffold_1	666933	766933
Aspergillus_fumigatus_AFIS_23107_CDC-12	45	39	6	0	scaffold_2	3380824	3480824
Aspergillus_fumigatus_AFIS_23107_CDC-12	44	42	2	0	scaffold_2	3854309	3954309
Aspergillus_fumigatus_AFIS_23107_CDC-12	22	2	20	0	scaffold_7	1748766	1848766
Aspergillus_fumigatus_AFIS_23107_CDC-12	32	29	3	0	scaffold_4	1881580	1981580
Aspergillus_fumigatus_AFIS_23107_CDC-12	29	28	1	0	scaffold_5	297597	397597
Aspergillus_fumigatus_AFIS_23107_CDC-12	15	13	2	0	scaffold_1	2335371	2435371
Aspergillus_fumigatus_AFIS_23107_CDC-12	36	33	3	0	scaffold_3	1500553	1600553
Aspergillus_fumigatus_AFIS_23107_CDC-12	37	35	2	0	scaffold_1	3539222	3639222
Aspergillus_fumigatus_AFIS_23107_CDC-12	41	38	3	0	scaffold_3	929180	1029180
Aspergillus_fumigatus_AFIS_23107_CDC-12	35	33	2	0	scaffold_5	2875920	2975920
Aspergillus_fumigatus_AFIS_23107_CDC-12	39	37	2	0	scaffold_5	2250268	2350268
Aspergillus_fumigatus_AFIS_23107_CDC-12	36	29	7	0	scaffold_4	2295670	2395670
Aspergillus_fumigatus_AFIS_23107_CDC-12	47	42	5	0	scaffold_6	538711	638711
Aspergillus_fumigatus_AFIS_23107_CDC-12	36	35	1	0	scaffold_1	2088881	2188881
Aspergillus_fumigatus_AFIS_23107_CDC-12	38	34	4	0	scaffold_7	1334571	1434571
Aspergillus_fumigatus_AFIS_23107_CDC-12	38	30	8	0	scaffold_1	902407	1002407
Aspergillus_fumigatus_AFIS_23107_CDC-12	30	27	3	0	scaffold_3	3042600	3142600
Aspergillus_fumigatus_AFIS_23107_CDC-12	36	32	4	0	scaffold_3	1826001	1926001
Aspergillus_fumigatus_AFIS_23107_CDC-12	34	29	5	0	scaffold_1	1152620	1252620
Aspergillus_fumigatus_AFIS_23107_CDC-12	35	31	4	0	scaffold_5	3568890	3668890
Aspergillus_fumigatus_AFIS_23107_CDC-12	44	43	1	0	scaffold_6	1402409	1502409
Aspergillus_fumigatus_AFIS_23107_CDC-12	30	28	2	0	scaffold_2	2718040	2818040
Aspergillus_fumigatus_AFIS_23107_CDC-12	47	34	13	0	scaffold_2	113468	213468
Aspergillus_fumigatus_AFIS_23107_CDC-12	30	25	5	0	scaffold_8	961800	1061800
Aspergillus_fumigatus_AFIS_23107_CDC-12	42	41	1	0	scaffold_1	2002758	2102758
Aspergillus_fumigatus_AFIS_23107_CDC-12	34	34	0	0	scaffold_3	2764366	2864366
Aspergillus_fumigatus_AFIS_23107_CDC-12	37	36	1	0	scaffold_1	2907333	3007333
Aspergillus_fumigatus_AFIS_23107_CDC-12	43	38	5	0	scaffold_1	4022318	4122318
Aspergillus_fumigatus_AFIS_23107_CDC-12	31	27	4	0	scaffold_6	382061	482061
Aspergillus_fumigatus_AFIS_23107_CDC-12	38	36	2	0	scaffold_7	831027	931027
Aspergillus_fumigatus_AFIS_23107_CDC-12	31	30	1	0	scaffold_6	2253481	2353481
Aspergillus_fumigatus_AFIS_23107_CDC-12	38	36	2	0	scaffold_5	1841528	1941528
Aspergillus_fumigatus_AFIS_23107_CDC-12	30	26	4	0	scaffold_7	1289896	1389896
Aspergillus_fumigatus_AFIS_23107_CDC-12	29	28	1	0	scaffold_6	2290630	2390630
Aspergillus_fumigatus_AFIS_23107_CDC-12	32	31	1	0	scaffold_1	3564378	3664378
Aspergillus_fumigatus_AFIS_23107_CDC-12	33	31	2	0	scaffold_8	1398243	1498243
Aspergillus_fumigatus_AFIS_23107_CDC-12	42	33	9	0	scaffold_2	3271349	3371349
Aspergillus_fumigatus_AFIS_23107_CDC-12	41	37	4	0	scaffold_8	763583	863583
Aspergillus_fumigatus_AFIS_23107_CDC-12	40	37	3	0	scaffold_5	1100735	1200735
Aspergillus_fumigatus_AFIS_23107_CDC-12	33	30	3	0	scaffold_1	3631241	3731241
Aspergillus_fumigatus_AFIS_23107_CDC-12	28	26	2	0	scaffold_2	1448638	1548638
Aspergillus_fumigatus_AFIS_23107_CDC-12	40	34	6	0	scaffold_2	3946120	4046120
Aspergillus_fumigatus_AFIS_23107_CDC-12	39	35	4	0	scaffold_5	1190369	1290369
Aspergillus_fumigatus_AFIS_23107_CDC-12	37	35	2	0	scaffold_3	437170	537170
Aspergillus_fumigatus_AFIS_23107_CDC-12	35	29	6	0	scaffold_6	1952435	2052435
Aspergillus_fumigatus_AFIS_23107_CDC-12	43	38	5	0	scaffold_7	129047	229047
Aspergillus_fumigatus_AFIS_23107_CDC-12	29	28	1	0	scaffold_5	301147	401147
Aspergillus_fumigatus_AFIS_23107_CDC-12	34	30	4	0	scaffold_1	3659198	3759198
Aspergillus_fumigatus_AFIS_23107_CDC-12	36	30	6	0	scaffold_1	4580102	4680102
Aspergillus_fumigatus_AFIS_23107_CDC-12	38	34	4	0	scaffold_1	356066	456066
Aspergillus_fumigatus_AFIS_23107_CDC-12	44	44	0	0	scaffold_6	2495693	2595693
Aspergillus_fumigatus_AFIS_23107_CDC-12	33	33	0	0	scaffold_3	2817910	2917910
Aspergillus_fumigatus_AFIS_23107_CDC-12	16	16	0	0	scaffold_3	1269709	1369709
Aspergillus_fumigatus_AFIS_23107_CDC-12	20	4	16	0	scaffold_1	29732	129732
Aspergillus_fumigatus_AFIS_23107_CDC-12	26	26	0	0	scaffold_6	2362852	2462852
Aspergillus_fumigatus_AFIS_23107_CDC-12	35	32	3	0	scaffold_2	2759134	2859134
Aspergillus_fumigatus_AFIS_23107_CDC-12	35	30	5	0	scaffold_2	2944420	3044420
Aspergillus_fumigatus_AFIS_23107_CDC-12	17	15	2	0	scaffold_4	1101441	1201441
Aspergillus_fumigatus_AFIS_23107_CDC-12	38	35	3	0	scaffold_2	1146568	1246568
Aspergillus_fumigatus_AFIS_23107_CDC-12	33	30	3	0	scaffold_3	3497750	3597750
Aspergillus_fumigatus_AFIS_23107_CDC-12	27	22	5	0	scaffold_2	2048100	2148100
Aspergillus_fumigatus_AFIS_23107_CDC-12	44	38	6	0	scaffold_2	3373692	3473692
Aspergillus_fumigatus_AFIS_23107_CDC-12	34	31	3	0	scaffold_2	1545434	1645434
Aspergillus_fumigatus_AFIS_23107_CDC-12	43	38	5	0	scaffold_7	133056	233056
Aspergillus_fumigatus_AFIS_23107_CDC-12	32	30	2	0	scaffold_3	3093189	3193189
Aspergillus_fumigatus_AFIS_23107_CDC-12	31	30	1	0	scaffold_6	2392243	2492243
Aspergillus_fumigatus_AFIS_23107_CDC-12	32	31	1	0	scaffold_2	1476166	1576166
Aspergillus_fumigatus_AFIS_23107_CDC-12	33	32	1	0	scaffold_6	2906848	3006848
Aspergillus_fumigatus_AFIS_23107_CDC-12	33	32	1	0	scaffold_6	2593179	2693179
Aspergillus_fumigatus_AFIS_23107_CDC-12	39	30	9	0	scaffold_6	3280692	3380692
Aspergillus_fumigatus_AFIS_23107_CDC-12	34	32	2	0	scaffold_5	1166614	1266614
Aspergillus_fumigatus_AFIS_23107_CDC-12	34	28	6	0	scaffold_1	4542637	4642637
Aspergillus_fumigatus_AFIS_23107_CDC-12	36	33	3	0	scaffold_3	1885615	1985615
Aspergillus_fumigatus_AFIS_23107_CDC-12	40	35	5	0	scaffold_4	543682	643682
Aspergillus_fumigatus_AFIS_23107_CDC-12	33	31	2	0	scaffold_2	830757	930757
Aspergillus_fumigatus_AFIS_23107_CDC-12	37	35	2	0	scaffold_2	2263351	2363351
Aspergillus_fumigatus_AFIS_23107_CDC-12	34	31	3	0	scaffold_1	3475531	3575531
Aspergillus_fumigatus_AFIS_23107_CDC-12	32	29	3	0	scaffold_1	4244598	4344598
Aspergillus_fumigatus_AFIS_23107_CDC-12	39	34	5	0	scaffold_2	254894	354894
Aspergillus_fumigatus_AFIS_23107_CDC-12	34	32	2	0	scaffold_2	2516333	2616333
Aspergillus_fumigatus_AFIS_23107_CDC-12	35	35	0	0	scaffold_5	2900177	3000177
Aspergillus_fumigatus_AFIS_23107_CDC-12	45	39	6	0	scaffold_2	3378906	3478906
Aspergillus_fumigatus_AFIS_23107_CDC-12	44	39	5	0	scaffold_5	3052152	3152152
Aspergillus_fumigatus_AFIS_23107_CDC-12	39	35	4	0	scaffold_2	229108	329108
Aspergillus_fumigatus_AFIS_23107_CDC-12	34	30	4	0	scaffold_4	3150415	3250415
Aspergillus_fumigatus_AFIS_23107_CDC-12	28	18	10	0	scaffold_5	346287	446287
Aspergillus_fumigatus_AFIS_23107_CDC-12	36	35	1	0	scaffold_6	2569028	2669028
Aspergillus_fumigatus_AFIS_23107_CDC-12	35	31	4	0	scaffold_1	1576095	1676095
Aspergillus_fumigatus_AFIS_23107_CDC-12	23	21	2	0	scaffold_7	740653	840653
Aspergillus_fumigatus_AFIS_23107_CDC-12	44	36	8	0	scaffold_4	300594	400594
Aspergillus_fumigatus_AFIS_23107_CDC-12	32	32	0	0	scaffold_2	2474941	2574941
Aspergillus_fumigatus_AFIS_23107_CDC-12	25	21	4	0	scaffold_3	73171	173171
Aspergillus_fumigatus_AFIS_23107_CDC-12	33	31	2	0	scaffold_4	1558563	1658563
Aspergillus_fumigatus_AFIS_23107_CDC-12	36	30	6	0	scaffold_2	3591491	3691491
Aspergillus_fumigatus_AFIS_23107_CDC-12	39	37	2	0	scaffold_2	2112373	2212373
Aspergillus_fumigatus_AFIS_23107_CDC-12	38	34	4	0	scaffold_2	3454475	3554475
Aspergillus_fumigatus_AFIS_23107_CDC-12	9	9	0	0	scaffold_8	670429	770429
Aspergillus_fumigatus_AFIS_23107_CDC-12	39	37	2	0	scaffold_5	2220729	2320729
Aspergillus_fumigatus_AFIS_23107_CDC-12	36	36	0	0	scaffold_2	519171	619171
Aspergillus_fumigatus_AFIS_23107_CDC-12	32	29	3	0	scaffold_4	1876745	1976745
Aspergillus_fumigatus_AFIS_23107_CDC-12	28	27	1	0	scaffold_4	2748350	2848350
Aspergillus_fumigatus_AFIS_23107_CDC-12	16	15	1	0	scaffold_3	1261091	1361091
Aspergillus_fumigatus_AFIS_23107_CDC-12	45	42	3	0	scaffold_1	4660179	4760179
Aspergillus_fumigatus_AFIS_23107_CDC-12	40	37	3	0	scaffold_1	2232495	2332495
Aspergillus_fumigatus_AFIS_23107_CDC-12	32	29	3	0	scaffold_2	3681045	3781045
Aspergillus_fumigatus_AFIS_23107_CDC-12	48	40	8	0	scaffold_3	2601051	2701051
Aspergillus_fumigatus_AFIS_23107_CDC-12	35	35	0	0	scaffold_2	575237	675237
Aspergillus_fumigatus_AFIS_23107_CDC-12	44	40	4	0	scaffold_6	645294	745294
Aspergillus_fumigatus_AFIS_23107_CDC-12	32	30	1	1	scaffold_4	3243296	3343296
Aspergillus_fumigatus_AFIS_23107_CDC-12	27	24	3	0	scaffold_1	3003691	3103691
Aspergillus_fumigatus_AFIS_23107_CDC-12	21	2	19	0	scaffold_7	1727571	1827571
Aspergillus_fumigatus_AFIS_23107_CDC-12	40	0	40	0	scaffold_2	4465380	4565380
Aspergillus_fumigatus_AFIS_23107_CDC-12	32	25	7	0	scaffold_2	1025463	1125463
Aspergillus_fumigatus_AFIS_23107_CDC-12	32	30	2	0	scaffold_6	1684592	1784592
Aspergillus_fumigatus_AFIS_23107_CDC-12	41	38	3	0	scaffold_1	2479353	2579353
Aspergillus_fumigatus_AFIS_23107_CDC-12	32	26	6	0	scaffold_6	206848	306848
Aspergillus_fumigatus_AFIS_23107_CDC-12	29	20	9	0	scaffold_5	341366	441366
Aspergillus_fumigatus_AFIS_23107_CDC-12	34	32	2	0	scaffold_3	797063	897063
Aspergillus_fumigatus_AFIS_23107_CDC-12	38	36	2	0	scaffold_2	2282945	2382945
Aspergillus_fumigatus_AFIS_23107_CDC-12	38	33	5	0	scaffold_8	16269	116269
Aspergillus_fumigatus_AFIS_23107_CDC-12	12	10	2	0	scaffold_5	2370237	2470237
Aspergillus_fumigatus_AFIS_23107_CDC-12	30	27	3	0	scaffold_3	3033921	3133921
Aspergillus_fumigatus_AFIS_23107_CDC-12	37	37	0	0	scaffold_4	1655139	1755139
Aspergillus_fumigatus_AFIS_23107_CDC-12	33	11	22	0	scaffold_4	761573	861573
Aspergillus_fumigatus_AFIS_23107_CDC-12	38	38	0	0	scaffold_5	3426038	3526038
Aspergillus_fumigatus_AFIS_23107_CDC-12	27	24	3	0	scaffold_3	1185718	1285718
Aspergillus_fumigatus_AFIS_23107_CDC-12	40	35	5	0	scaffold_2	3309696	3409696
Aspergillus_fumigatus_AFIS_23107_CDC-12	49	35	14	0	scaffold_2	108664	208664
Aspergillus_fumigatus_AFIS_23107_CDC-12	30	28	2	0	scaffold_6	1038479	1138479
Aspergillus_fumigatus_AFIS_23107_CDC-12	32	30	2	0	scaffold_6	1052484	1152484
Aspergillus_fumigatus_AFIS_23107_CDC-12	40	35	5	0	scaffold_5	2644101	2744101
Aspergillus_fumigatus_AFIS_23107_CDC-12	41	39	2	0	scaffold_6	1465024	1565024
Aspergillus_fumigatus_AFIS_23107_CDC-12	41	33	8	0	scaffold_2	3326273	3426273
Aspergillus_fumigatus_AFIS_23107_CDC-12	43	41	2	0	scaffold_2	4763765	4863765
Aspergillus_fumigatus_AFIS_23107_CDC-12	38	36	2	0	scaffold_1	2657328	2757328
Aspergillus_fumigatus_AFIS_23107_CDC-12	35	33	2	0	scaffold_6	792220	892220
Aspergillus_fumigatus_AFIS_23107_CDC-12	33	33	0	0	scaffold_4	1633581	1733581
Aspergillus_fumigatus_AFIS_23107_CDC-12	34	32	2	0	scaffold_2	1317592	1417592
Aspergillus_fumigatus_AFIS_23107_CDC-12	43	40	3	0	scaffold_2	3884973	3984973
Aspergillus_fumigatus_AFIS_23107_CDC-12	43	37	6	0	scaffold_1	4815519	4915519
Aspergillus_fumigatus_AFIS_23107_CDC-12	44	39	5	0	scaffold_5	1757161	1857161
Aspergillus_fumigatus_AFIS_23107_CDC-12	35	32	3	0	scaffold_2	3650196	3750196
Aspergillus_fumigatus_AFIS_23107_CDC-12	33	30	3	0	scaffold_5	3560756	3660756
Aspergillus_fumigatus_AFIS_23107_CDC-12	26	23	3	0	scaffold_5	1498224	1598224
Aspergillus_fumigatus_AFIS_23107_CDC-12	36	1	35	0	scaffold_7	1949172	2049172
Aspergillus_fumigatus_AFIS_23107_CDC-12	38	36	2	0	scaffold_1	1818469	1918469
Aspergillus_fumigatus_AFIS_23107_CDC-12	35	33	2	0	scaffold_6	2810229	2910229
Aspergillus_fumigatus_AFIS_23107_CDC-12	35	31	4	0	scaffold_7	25753	125753
Aspergillus_fumigatus_AFIS_23107_CDC-12	35	32	3	0	scaffold_1	4171840	4271840
Aspergillus_fumigatus_AFIS_23107_CDC-12	52	43	9	0	scaffold_5	75662	175662
Aspergillus_fumigatus_AFIS_23107_CDC-12	41	33	8	0	scaffold_8	1711721	1811721
Aspergillus_fumigatus_AFIS_23107_CDC-12	37	35	2	0	scaffold_7	471012	571012
Aspergillus_fumigatus_AFIS_23107_CDC-12	31	29	2	0	scaffold_3	1396999	1496999
Aspergillus_fumigatus_AFIS_23107_CDC-12	39	37	2	0	scaffold_3	2389193	2489193
Aspergillus_fumigatus_AFIS_23107_CDC-12	39	30	9	0	scaffold_6	1809174	1909174
Aspergillus_fumigatus_AFIS_23107_CDC-12	39	34	5	0	scaffold_2	1165797	1265797
Aspergillus_fumigatus_AFIS_23107_CDC-12	40	39	1	0	scaffold_5	2264315	2364315
Aspergillus_fumigatus_AFIS_23107_CDC-12	33	30	3	0	scaffold_6	764692	864692
Aspergillus_fumigatus_AFIS_23107_CDC-12	20	16	4	0	scaffold_8	598234	698234
Aspergillus_fumigatus_AFIS_23107_CDC-12	42	36	6	0	scaffold_2	3040640	3140640
Aspergillus_fumigatus_AFIS_23107_CDC-12	38	34	4	0	scaffold_2	1220873	1320873
Aspergillus_fumigatus_AFIS_23107_CDC-12	31	28	3	0	scaffold_7	1240725	1340725
Aspergillus_fumigatus_AFIS_23107_CDC-12	22	21	1	0	scaffold_8	857303	957303
Aspergillus_fumigatus_AFIS_23107_CDC-12	38	35	3	0	scaffold_2	2267970	2367970
Aspergillus_fumigatus_AFIS_23107_CDC-12	38	32	6	0	scaffold_2	4240573	4340573
Aspergillus_fumigatus_AFIS_23107_CDC-12	39	36	3	0	scaffold_1	2630315	2730315
Aspergillus_fumigatus_AFIS_23107_CDC-12	27	26	1	0	scaffold_4	2784908	2884908
Aspergillus_fumigatus_AFIS_23107_CDC-12	43	42	1	0	scaffold_6	2455236	2555236
Aspergillus_fumigatus_AFIS_23107_CDC-12	41	37	4	0	scaffold_1	1902947	2002947
Aspergillus_fumigatus_AFIS_23107_CDC-12	41	34	7	0	scaffold_7	99154	199154
Aspergillus_fumigatus_AFIS_23107_CDC-12	27	26	1	0	scaffold_5	303652	403652
Aspergillus_fumigatus_AFIS_23107_CDC-12	19	5	14	0	scaffold_7	1657816	1757816
Aspergillus_fumigatus_AFIS_23107_CDC-12	40	37	3	0	scaffold_5	781820	881820
Aspergillus_fumigatus_AFIS_23107_CDC-12	40	39	1	0	scaffold_2	2137871	2237871
Aspergillus_fumigatus_AFIS_23107_CDC-12	41	36	5	0	scaffold_8	34977	134977
Aspergillus_fumigatus_AFIS_23107_CDC-12	43	37	6	0	scaffold_1	4811418	4911418
Aspergillus_fumigatus_AFIS_23107_CDC-12	36	34	2	0	scaffold_5	2854998	2954998
Aspergillus_fumigatus_AFIS_23107_CDC-12	45	39	6	0	scaffold_7	279574	379574
Aspergillus_fumigatus_AFIS_23107_CDC-12	30	28	2	0	scaffold_1	1362685	1462685
Aspergillus_fumigatus_AFIS_23107_CDC-12	32	28	4	0	scaffold_8	1420687	1520687
Aspergillus_fumigatus_AFIS_23107_CDC-12	44	37	7	0	scaffold_5	3076144	3176144
Aspergillus_fumigatus_AFIS_23107_CDC-12	38	35	3	0	scaffold_5	1807526	1907526
Aspergillus_fumigatus_AFIS_23107_CDC-12	33	31	2	0	scaffold_7	1221925	1321925
Aspergillus_fumigatus_AFIS_23107_CDC-12	42	32	10	0	scaffold_7	1093903	1193903
Aspergillus_fumigatus_AFIS_23107_CDC-12	29	28	1	0	scaffold_4	2791725	2891725
Aspergillus_fumigatus_AFIS_23107_CDC-12	20	17	3	0	scaffold_5	171974	271974
Aspergillus_fumigatus_AFIS_23107_CDC-12	24	20	4	0	scaffold_1	2384010	2484010
Aspergillus_fumigatus_AFIS_23107_CDC-12	13	0	13	0	scaffold_7	1811379	1911379
Aspergillus_fumigatus_AFIS_23107_CDC-12	29	24	5	0	scaffold_6	1979267	2079267
Aspergillus_fumigatus_AFIS_23107_CDC-12	42	39	3	0	scaffold_5	2799413	2899413
Aspergillus_fumigatus_AFIS_23107_CDC-12	35	34	1	0	scaffold_8	1072083	1172083
Aspergillus_fumigatus_AFIS_23107_CDC-12	35	27	8	0	scaffold_2	3509587	3609587
